name	taxonomy_id	taxonomy_lvl	kraken_assigned_reads	added_reads	new_est_reads	total_reads	kraken_fraction_total_reads	bracken_fraction_total_reads
unclassified	0	U	157081	0	157081	1244604	0.126210	0.126210
Pseudomonas putida	303	S	70529	20970	91499	1244604	0.056668	0.073517
Klebsiella pneumoniae	573	S	33776	44433	78209	1244604	0.027138	0.062838
Providencia rettgeri	587	S	51878	18229	70107	1244604	0.041682	0.056329
Escherichia coli	562	S	24473	44698	69171	1244604	0.019663	0.055577
Comamonas aquatica	225991	S	60004	1133	61137	1244604	0.048211	0.049122
Pseudomonas mosselii	78327	S	24964	24765	49729	1244604	0.020058	0.039956
Citrobacter phage Miller	1527524	S	7302	23702	31004	1244604	0.005867	0.024911
Citrobacter phage vB_CfrM_CfP1	1871313	S	6727	21117	27844	1244604	0.005405	0.022372
Citrobacter freundii	546	S	10085	14212	24297	1244604	0.008103	0.019522
Pantoea agglomerans	549	S	18643	769	19412	1244604	0.014979	0.015597
Pantoea vagans	470934	S	9983	7048	17031	1244604	0.008021	0.013684
Pseudomonas monteilii	76759	S	5490	9251	14741	1244604	0.004411	0.011844
Pseudomonas resinovorans	53412	S	48	13930	13978	1244604	0.000039	0.011231
Escherichia virus PBECO4	2560463	S	8074	4042	12116	1244604	0.006487	0.009735
Aeromonas simiae	218936	S	11672	234	11906	1244604	0.009378	0.009566
Proteus vulgaris	585	S	8819	2672	11491	1244604	0.007086	0.009233
Escherichia virus 121Q	2560436	S	6966	3505	10471	1244604	0.005597	0.008413
Klebsiella virus JD18	1985326	S	7685	1212	8897	1244604	0.006175	0.007148
Providencia phage Redjac	1235559	S	8775	111	8886	1244604	0.007050	0.007140
Citrobacter phage IME-CF2	1673887	S	2532	5712	8244	1244604	0.002034	0.006624
Aeromonas caviae	648	S	4243	3920	8163	1244604	0.003409	0.006559
Pantoea sp. PSNIH1	1484158	S	7384	757	8141	1244604	0.005933	0.006541
Klebsiella quasipneumoniae	1463165	S	4912	2760	7672	1244604	0.003947	0.006164
Aeromonas hydrophila	644	S	5061	2245	7306	1244604	0.004066	0.005870
Pseudomonas sp. RtIB026	2749999	S	7076	131	7207	1244604	0.005685	0.005791
Enterobacter cloacae	550	S	4900	1819	6719	1244604	0.003937	0.005399
Morganella morganii	582	S	6580	120	6700	1244604	0.005287	0.005383
Klebsiella virus KP15	1985337	S	1728	4653	6381	1244604	0.001388	0.005127
Klebsiella virus K64-1	2560541	S	4028	2271	6299	1244604	0.003236	0.005061
Providencia stuartii	588	S	3422	2833	6255	1244604	0.002749	0.005026
Klebsiella virus RaK2	2560545	S	3887	2202	6089	1244604	0.003123	0.004892
Lysinibacillus sp. FJAT-51161	2590012	S	5740	179	5919	1244604	0.004612	0.004756
Citrobacter virus Moogle	1985304	S	5202	327	5529	1244604	0.004180	0.004442
Providencia alcalifaciens	126385	S	5363	109	5472	1244604	0.004309	0.004397
Klebsiella virus Matisse	1985339	S	2352	3066	5418	1244604	0.001890	0.004353
Klebsiella phage vB_KpnM_KpV477	1852625	S	5069	329	5398	1244604	0.004073	0.004337
Citrobacter portucalensis	1639133	S	1471	3876	5347	1244604	0.001182	0.004296
Klebsiella phage KNP2	1871716	S	2761	2341	5102	1244604	0.002218	0.004099
Cronobacter phage vB_CsaM_GAP161	1141138	S	3640	1321	4961	1244604	0.002925	0.003986
Pantoea dispersa	59814	S	4665	217	4882	1244604	0.003748	0.003923
Pseudomonas aeruginosa	287	S	2930	1930	4860	1244604	0.002354	0.003905
Pseudomonas sp. SK	2729423	S	4478	46	4524	1244604	0.003598	0.003635
Klebsiella virus KP27	1985338	S	1620	2784	4404	1244604	0.001302	0.003538
Citrobacter sp. RHBSTW-00053	2742632	S	117	4242	4359	1244604	0.000094	0.003502
Citrobacter virus Merlin	1985341	S	4095	185	4280	1244604	0.003290	0.003439
Klebsiella virus Miro	1985340	S	1498	2704	4202	1244604	0.001204	0.003376
Klebsiella phage vB_KpnM_BIS47	1907784	S	1905	1801	3706	1244604	0.001531	0.002978
Salmonella enterica	28901	S	1749	1896	3645	1244604	0.001405	0.002929
Enterobacter roggenkampii	1812935	S	2570	1038	3608	1244604	0.002065	0.002899
Raoultella phage Ro1	2053702	S	2875	487	3362	1244604	0.002310	0.002701
Enterobacter hormaechei	158836	S	1200	1977	3177	1244604	0.000964	0.002553
Klebsiella phage vB_KpnM_KB57	1719140	S	1606	1505	3111	1244604	0.001290	0.002500
Shigella virus Sf14	2560757	S	2438	615	3053	1244604	0.001959	0.002453
Proteus phage Mydo	2483610	S	1298	1711	3009	1244604	0.001043	0.002418
Citrobacter sp. CRE-46	1703250	S	983	2011	2994	1244604	0.000790	0.002406
Escherichia virus ECOO78	2560443	S	2284	687	2971	1244604	0.001835	0.002387
Klebsiella virus PKO111	1985327	S	2400	520	2920	1244604	0.001928	0.002346
Pseudomonas sp. 14181154	2662033	S	2546	200	2746	1244604	0.002046	0.002206
Pseudomonas sp. Leaf58	1736226	S	2632	17	2649	1244604	0.002115	0.002128
Pantoea ananatis	553	S	2585	53	2638	1244604	0.002077	0.002120
Pseudomonas fulva	47880	S	1252	1344	2596	1244604	0.001006	0.002086
Pseudomonas entomophila	312306	S	2564	25	2589	1244604	0.002060	0.002080
Escherichia virus ep3	1918727	S	1999	588	2587	1244604	0.001606	0.002079
Pantoea sp. MT58	2768165	S	509	2017	2526	1244604	0.000409	0.002030
Escherichia virus CVM10	1918726	S	2521	0	2521	1244604	0.002026	0.002026
Klebsiella aerogenes	548	S	2414	99	2513	1244604	0.001940	0.002019
Klebsiella virus KpS8	2723896	S	1001	1487	2488	1244604	0.000804	0.001999
Pseudomonas plecoglossicida	70775	S	1584	879	2463	1244604	0.001273	0.001979
Escherichia virus SU10	1987942	S	2190	198	2388	1244604	0.001760	0.001919
Proteus mirabilis	584	S	2289	86	2375	1244604	0.001839	0.001908
Homo sapiens	9606	S	2242	23	2265	1244604	0.001801	0.001820
Shigella virus Sf17	2560758	S	1440	740	2180	1244604	0.001157	0.001752
Shigella virus Sf13	2560756	S	1387	769	2156	1244604	0.001114	0.001732
Pseudomonas sp. CCOS 191	1649877	S	1978	90	2068	1244604	0.001589	0.001662
Escherichia virus phiEco32	490103	S	1874	168	2042	1244604	0.001506	0.001641
Aeromonas veronii	654	S	1755	119	1874	1244604	0.001410	0.001506
Klebsiella virus KpS110	2731623	S	1132	732	1864	1244604	0.000910	0.001498
Proteus sp. 3M	1232493	S	1448	378	1826	1244604	0.001163	0.001467
Citrobacter virus Moon	1985342	S	1433	384	1817	1244604	0.001151	0.001460
Escherichia virus RB43	115991	S	808	1009	1817	1244604	0.000649	0.001460
Pseudomonas sp. CFA	2651048	S	686	1095	1781	1244604	0.000551	0.001431
Escherichia phage Lw1	1307804	S	1269	512	1781	1244604	0.001020	0.001431
Serratia marcescens	615	S	1034	711	1745	1244604	0.000831	0.001402
Pantoea sp. SO10	2575375	S	1710	31	1741	1244604	0.001374	0.001399
Citrobacter virus CF1	2560383	S	1315	411	1726	1244604	0.001057	0.001387
Enterobacter virus Eap3	1985336	S	1296	346	1642	1244604	0.001041	0.001319
Pantoea eucalypti	470933	S	357	1253	1610	1244604	0.000287	0.001294
Klebsiella virus PMBT1	2560544	S	436	1173	1609	1244604	0.000350	0.001293
Proteus penneri	102862	S	1431	81	1512	1244604	0.001150	0.001215
Salmonella sp.	599	S	126	1352	1478	1244604	0.000101	0.001188
Klebsiella virus UPM 2146	2656521	S	798	677	1475	1244604	0.000641	0.001185
Pantoea stewartii	66269	S	1417	46	1463	1244604	0.001139	0.001175
Citrobacter sp. RHBSTW-00859	2742666	S	2	1434	1436	1244604	0.000002	0.001154
Cronobacter phage vB_CsaM_leB	1885242	S	433	985	1418	1244604	0.000348	0.001139
Cronobacter phage vB_CsaM_leE	1873954	S	473	937	1410	1244604	0.000380	0.001133
Klebsiella variicola	244366	S	930	476	1406	1244604	0.000747	0.001130
Pantoea sp. SM3640	2787629	S	333	1031	1364	1244604	0.000268	0.001096
Plesiomonas shigelloides	703	S	1346	5	1351	1244604	0.001081	0.001085
Citrobacter braakii	57706	S	363	979	1342	1244604	0.000292	0.001078
Aeromonas dhakensis	196024	S	1117	167	1284	1244604	0.000897	0.001032
Citrobacter phage Margaery	1701810	S	966	315	1281	1244604	0.000776	0.001029
Klebsiella virus 0507KN21	2169687	S	695	566	1261	1244604	0.000558	0.001013
Pseudomonas sp. PONIH3	1636610	S	931	328	1259	1244604	0.000748	0.001012
Citrobacter virus Mordin	1985305	S	285	964	1249	1244604	0.000229	0.001004
Aeromonas sp. WP2-W18-CRE-05	2675707	S	177	1067	1244	1244604	0.000142	0.001000
Citrobacter cronae	1748967	S	295	943	1238	1244604	0.000237	0.000995
Pantoea cypripedii	55209	S	1228	8	1236	1244604	0.000987	0.000993
Enterobacter kobei	208224	S	691	535	1226	1244604	0.000555	0.000985
Providencia rustigianii	158850	S	1201	24	1225	1244604	0.000965	0.000984
Klebsiella virus Menlow	2731625	S	560	618	1178	1244604	0.000450	0.000946
Pantoea sp. At-9b	592316	S	995	171	1166	1244604	0.000799	0.000937
Salmonella phage IME207	1873985	S	1159	3	1162	1244604	0.000931	0.000934
Salmonella sp. SSDFZ54	2500542	S	357	804	1161	1244604	0.000287	0.000933
Pantoea sp. MSR2	2052056	S	911	235	1146	1244604	0.000732	0.000921
Pseudomonas sp. FGI182	1259844	S	1025	111	1136	1244604	0.000824	0.000913
Klebsiella phage Magnus	2589660	S	627	495	1122	1244604	0.000504	0.000901
Pantoea rwandensis	1076550	S	1092	20	1112	1244604	0.000877	0.000893
Aeromonas salmonicida	645	S	949	135	1084	1244604	0.000762	0.000871
Escherichia virus RB16	329381	S	505	559	1064	1244604	0.000406	0.000855
Pseudomonas sp. SWI7	2587597	S	473	587	1060	1244604	0.000380	0.000852
Pseudomonas soli	1306993	S	820	237	1057	1244604	0.000659	0.000849
Raoultella ornithinolytica	54291	S	663	383	1046	1244604	0.000533	0.000840
Pseudomonas sp. XWY-1	2069256	S	395	649	1044	1244604	0.000317	0.000839
Aeromonas sp. ASNIH2	1636607	S	426	595	1021	1244604	0.000342	0.000820
Pseudomonas parafulva	157782	S	943	17	960	1244604	0.000758	0.000771
Citrobacter phage Michonne	1675603	S	197	761	958	1244604	0.000158	0.000770
Pseudomonas otitidis	319939	S	952	4	956	1244604	0.000765	0.000768
Providencia phage vB_PreS-Stilesk	2761110	S	652	270	922	1244604	0.000524	0.000741
Pseudomonas stutzeri	316	S	878	37	915	1244604	0.000705	0.000735
Proteus columbae	1987580	S	775	128	903	1244604	0.000623	0.000726
Klebsiella virus KpV80	2560543	S	837	57	894	1244604	0.000673	0.000718
Enterobacter asburiae	61645	S	587	304	891	1244604	0.000472	0.000716
Pseudomonas fluorescens	294	S	754	126	880	1244604	0.000606	0.000707
Proteus sp. ZN5	2697019	S	787	90	877	1244604	0.000632	0.000705
Pseudomonas sp. KBS0802	2578115	S	4	873	877	1244604	0.000003	0.000705
Klebsiella virus KP32	1985726	S	704	152	856	1244604	0.000566	0.000688
Pseudomonas sp. SWI6	2083051	S	144	711	855	1244604	0.000116	0.000687
Citrobacter sp. RHBSTW-00107	2742635	S	2	847	849	1244604	0.000002	0.000682
Pseudomonas sp. BJP69	2597770	S	623	221	844	1244604	0.000501	0.000678
Aeromonas media	651	S	740	104	844	1244604	0.000595	0.000678
Providencia phage vB_PreS-PibeRecoleta	2761109	S	590	251	841	1244604	0.000474	0.000676
Salmonella phage 64795_sal3	1813769	S	834	0	834	1244604	0.000670	0.000670
Escherichia virus KWBSE43-6	2731622	S	671	156	827	1244604	0.000539	0.000664
Citrobacter werkmanii	67827	S	420	405	825	1244604	0.000337	0.000663
Escherichia virus NCA	2733880	S	786	24	810	1244604	0.000632	0.000651
Escherichia virus 64795ec1	2733872	S	765	32	797	1244604	0.000615	0.000640
Salmonella virus 3A8767	2733881	S	751	44	795	1244604	0.000603	0.000639
Comamonas testosteroni	285	S	700	91	791	1244604	0.000562	0.000636
Delftia lacustris	558537	S	298	487	785	1244604	0.000239	0.000631
Escherichia virus SUSP1	1985290	S	664	121	785	1244604	0.000534	0.000631
Klebsiella africana	2489010	S	742	39	781	1244604	0.000596	0.000628
Comamonas kerstersii	225992	S	771	11	782	1244604	0.000619	0.000628
Citrobacter amalonaticus	35703	S	200	573	773	1244604	0.000161	0.000621
Pseudomonas sp. VLB120	69328	S	183	588	771	1244604	0.000147	0.000619
Providencia huaxiensis	2027290	S	144	625	769	1244604	0.000116	0.000618
Pseudomonas sp. SGAir0191	2217867	S	723	44	767	1244604	0.000581	0.000616
Klebsiella grimontii	2058152	S	320	424	744	1244604	0.000257	0.000598
Providencia sp. 1701011	2603244	S	1	741	742	1244604	0.000001	0.000596
Providencia vermicola	333965	S	703	18	721	1244604	0.000565	0.000579
Klebsiella virus JD001	2560540	S	629	84	713	1244604	0.000505	0.000573
Delftia tsuruhatensis	180282	S	304	404	708	1244604	0.000244	0.000569
Enterobacter sichuanensis	2071710	S	611	94	705	1244604	0.000491	0.000566
Klebsiella michiganensis	1134687	S	401	292	693	1244604	0.000322	0.000557
Pectinobacterium virus PEAT2	2560629	S	605	82	687	1244604	0.000486	0.000552
Salmonella phage Vi II-E1	424716	S	684	0	684	1244604	0.000550	0.000550
Aeromonas sp. ASNIH5	1758179	S	285	392	677	1244604	0.000229	0.000544
Klebsiella oxytoca	571	S	513	154	667	1244604	0.000412	0.000536
Pantoea alhagi	1891675	S	647	14	661	1244604	0.000520	0.000531
Escherichia virus NJ01	1987940	S	390	253	643	1244604	0.000313	0.000517
Providencia virus PS3	2733925	S	630	0	630	1244604	0.000506	0.000506
Enterobacter phage EspM4VN	2137745	S	558	58	616	1244604	0.000448	0.000495
Pseudomonas sp. URMO17WK12:I11	1283291	S	506	106	612	1244604	0.000407	0.000492
Pseudomonas chlororaphis	587753	S	593	19	612	1244604	0.000476	0.000492
Mixta gaviniae	665914	S	551	56	607	1244604	0.000443	0.000488
Pseudomonas mendocina	300	S	590	10	600	1244604	0.000474	0.000482
Escherichia virus N30	2733879	S	171	427	598	1244604	0.000137	0.000480
Pantoea sp. CCBC3-3-1	2490851	S	581	14	595	1244604	0.000467	0.000478
Aeromonas sp. ASNIH1	1636606	S	206	387	593	1244604	0.000166	0.000476
Comamonas thiooxydans	363952	S	538	51	589	1244604	0.000432	0.000473
Citrobacter sp. RHBSTW-00667	2742659	S	5	577	582	1244604	0.000004	0.000468
Erwinia gerundensis	1619313	S	565	13	578	1244604	0.000454	0.000464
Mixta calida	665913	S	504	74	578	1244604	0.000405	0.000464
Shigella sonnei	624	S	22	540	562	1244604	0.000018	0.000452
Enterococcus faecium	1352	S	501	56	557	1244604	0.000403	0.000448
Proteus terrae	1574161	S	218	336	554	1244604	0.000175	0.000445
Citrobacter sp. ABFQG	2529121	S	4	546	550	1244604	0.000003	0.000442
Klebsiella virus May	2731624	S	516	33	549	1244604	0.000415	0.000441
Pseudomonas asiatica	2219225	S	231	316	547	1244604	0.000186	0.000439
Leclercia adecarboxylata	83655	S	346	197	543	1244604	0.000278	0.000436
Pseudomonas sp. SWI36	2083052	S	334	205	539	1244604	0.000268	0.000433
Citrobacter sp. B72	2807631	S	150	357	507	1244604	0.000121	0.000407
Pseudomonas sp. 02C 26	2054914	S	494	1	495	1244604	0.000397	0.000398
Klebsiella virus KpV52	2560542	S	457	38	495	1244604	0.000367	0.000398
Pectobacterium carotovorum	554	S	380	109	489	1244604	0.000305	0.000393
Escherichia virus HZ2R8	2733877	S	402	84	486	1244604	0.000323	0.000390
Klebsiella virus myPSH1235	2733606	S	437	35	472	1244604	0.000351	0.000379
Pseudomonas oryzihabitans	47885	S	459	3	462	1244604	0.000369	0.000371
Lysinibacillus fusiformis	28031	S	355	107	462	1244604	0.000285	0.000371
Shigella boydii	621	S	112	346	458	1244604	0.000090	0.000368
Klebsiella quasivariicola	2026240	S	400	50	450	1244604	0.000321	0.000362
Escherichia virus 172-1	1987938	S	274	177	451	1244604	0.000220	0.000362
Salmonella virus SKML39	2169690	S	293	151	444	1244604	0.000235	0.000357
Klebsiella virus SU503	1920778	S	358	83	441	1244604	0.000288	0.000354
Escherichia virus Golestan	2560464	S	441	0	441	1244604	0.000354	0.000354
Raoultella virus RP180	2734197	S	439	1	440	1244604	0.000353	0.000354
Citrobacter sp. RHBSTW-00446	2742648	S	6	432	438	1244604	0.000005	0.000352
Providencia heimbachae	333962	S	430	5	435	1244604	0.000345	0.000350
Providencia sp. 2.29	2791982	S	32	393	425	1244604	0.000026	0.000341
Mixta theicola	1458355	S	361	62	423	1244604	0.000290	0.000340
Pseudomonas sp. CT14	341029	S	210	213	423	1244604	0.000169	0.000340
Klebsiella virus KPRio2015	2733601	S	355	66	421	1244604	0.000285	0.000338
Citrobacter sp. RHBSTW-00137	2742638	S	4	414	418	1244604	0.000003	0.000336
Shigella virus Pss1	1914206	S	254	160	414	1244604	0.000204	0.000333
Pseudomonas sp. 13159349	2662034	S	185	225	410	1244604	0.000149	0.000329
Delftia acidovorans	80866	S	273	131	404	1244604	0.000219	0.000325
Erwinia billingiae	182337	S	158	233	391	1244604	0.000127	0.000314
Citrobacter youngae	133448	S	163	226	389	1244604	0.000131	0.000313
Klebsiella virus K244	1920781	S	234	156	390	1244604	0.000188	0.000313
Acinetobacter baumannii	470	S	221	167	388	1244604	0.000178	0.000312
Citrobacter freundii complex sp. CFNIH9	2077149	S	113	269	382	1244604	0.000091	0.000307
Brucella anthropi	529	S	323	59	382	1244604	0.000260	0.000307
Lysinibacillus sphaericus	1421	S	269	108	377	1244604	0.000216	0.000303
Citrobacter sp. RHBSTW-00127	2742636	S	22	349	371	1244604	0.000018	0.000298
Klebsiella virus BO1E	2733600	S	341	28	369	1244604	0.000274	0.000296
Escherichia virus SUSP2	1985291	S	312	52	364	1244604	0.000251	0.000292
Escherichia virus C5	2733873	S	102	257	359	1244604	0.000082	0.000288
Shigella phage MK-13	2530042	S	194	157	351	1244604	0.000156	0.000282
Shigella flexneri	623	S	125	224	349	1244604	0.000100	0.000280
Escherichia fergusonii	564	S	260	84	344	1244604	0.000209	0.000276
Salmonella virus SPN3US	1984796	S	336	0	336	1244604	0.000270	0.000270
Proteus hauseri	183417	S	332	3	335	1244604	0.000267	0.000269
Pseudomonas cremoricolorata	157783	S	333	0	333	1244604	0.000268	0.000268
Pantoea sp. 201603H	2479547	S	327	3	330	1244604	0.000263	0.000265
Klebsiella virus KP34	1920777	S	275	53	328	1244604	0.000221	0.000264
Pseudomonas sp. SWI44	2083053	S	75	250	325	1244604	0.000060	0.000261
Klebsiella virus KpV48	2733603	S	278	47	325	1244604	0.000223	0.000261
Serratia virus IME250	2169688	S	321	2	323	1244604	0.000258	0.000260
Klebsiella virus Kp2	1980955	S	251	71	322	1244604	0.000202	0.000259
Cronobacter sakazakii	28141	S	191	127	318	1244604	0.000153	0.000256
Yersinia virus YpsPG	2733885	S	44	275	319	1244604	0.000035	0.000256
Dickeya virus AD1	2734080	S	317	0	317	1244604	0.000255	0.000255
Aeromonas jandaei	650	S	281	34	315	1244604	0.000226	0.000253
Klebsiella virus KpV74	2733604	S	297	17	314	1244604	0.000239	0.000252
Enterobacter phage Arya	1864622	S	312	0	312	1244604	0.000251	0.000251
Aeromonas sp. ASNIH7	1920107	S	46	264	310	1244604	0.000037	0.000249
Klebsiella virus AltoGao	2733599	S	290	17	307	1244604	0.000233	0.000247
Klebsiella virus KpS2	2733602	S	241	63	304	1244604	0.000194	0.000244
Listeria monocytogenes	1639	S	196	105	301	1244604	0.000157	0.000242
Enterobacteria virus IME390	2733870	S	294	6	300	1244604	0.000236	0.000241
Klebsiella virus KPV811	2733605	S	286	10	296	1244604	0.000230	0.000238
Klebsiella virus KpV41	1980956	S	198	96	294	1244604	0.000159	0.000236
Escherichia phage 13a	532076	S	273	16	289	1244604	0.000219	0.000232
Escherichia virus EG1	2733876	S	282	4	286	1244604	0.000227	0.000230
Kosakonia cowanii	208223	S	199	86	285	1244604	0.000160	0.000229
Aeromonas sp. ASNIH4	1636609	S	189	95	284	1244604	0.000152	0.000228
Edwardsiella tarda	636	S	87	194	281	1244604	0.000070	0.000226
Pseudomonas sp. BIGb0427	2724470	S	270	4	274	1244604	0.000217	0.000220
Shigella virus AG3	1987994	S	144	128	272	1244604	0.000116	0.000219
Pseudomonas syringae	317	S	201	66	267	1244604	0.000161	0.000215
Klebsiella virus SU552A	1920779	S	215	52	267	1244604	0.000173	0.000215
Escherichia virus K1H	1911010	S	186	81	267	1244604	0.000149	0.000215
Cedecea neteri	158822	S	251	15	266	1244604	0.000202	0.000214
Pluralibacter gergoviae	61647	S	259	6	265	1244604	0.000208	0.000213
Escherichia virus T7	1985738	S	217	48	265	1244604	0.000174	0.000213
Dickeya virus Limestone	1091052	S	43	219	262	1244604	0.000035	0.000211
Pseudomonas alkylphenolica	237609	S	260	1	261	1244604	0.000209	0.000210
Escherichia albertii	208962	S	251	9	260	1244604	0.000202	0.000209
Mixta intestinalis	1615494	S	224	36	260	1244604	0.000180	0.000209
Pseudomonas sp. SNU WT1	2518644	S	258	2	260	1244604	0.000207	0.000209
Escherichia marmotae	1499973	S	251	7	258	1244604	0.000202	0.000207
Citrobacter sp. RHBSTW-00944	2742671	S	15	239	254	1244604	0.000012	0.000204
Pseudomonas sp. R32	1573704	S	244	4	248	1244604	0.000196	0.000199
Klebsiella virus 2044-307w	2733663	S	137	111	248	1244604	0.000110	0.000199
Salmonella phage P46FS4	2712940	S	142	105	247	1244604	0.000114	0.000198
Klebsiella virus KpV475	1980958	S	173	72	245	1244604	0.000139	0.000197
Burkholderia cepacia	292	S	147	93	240	1244604	0.000118	0.000193
Erwinia persicina	55211	S	226	13	239	1244604	0.000182	0.000192
Klebsiella sp. WP3-S18-ESBL-05	2675711	S	19	219	238	1244604	0.000015	0.000191
Escherichia virus CICC80001	2733874	S	216	16	232	1244604	0.000174	0.000186
Escherichia virus K1ind1	1911007	S	151	81	232	1244604	0.000121	0.000186
Citrobacter sp. RHBSTW-00848	2742665	S	2	227	229	1244604	0.000002	0.000184
Escherichia virus Septima11	1987941	S	223	6	229	1244604	0.000179	0.000184
Xenorhabdus bovienii	40576	S	218	6	224	1244604	0.000175	0.000180
Escherichia virus Minorna	2733598	S	211	13	224	1244604	0.000170	0.000180
Providencia sneebia	516075	S	222	1	223	1244604	0.000178	0.000179
Aeromonas sp. 2692-1	2560029	S	101	120	221	1244604	0.000081	0.000178
Klebsiella virus KpV71	1980957	S	111	111	222	1244604	0.000089	0.000178
Pseudomonas sp. LTGT-11-2Z	2479393	S	32	187	219	1244604	0.000026	0.000176
Citrobacter rodentium	67825	S	167	51	218	1244604	0.000134	0.000175
Klebsiella virus F19	1920780	S	200	16	216	1244604	0.000161	0.000174
Pseudomonas sediminis	1691904	S	209	2	211	1244604	0.000168	0.000170
Nissabacter sp. SGAir0207	2126321	S	208	1	209	1244604	0.000167	0.000168
Pseudomonas taiwanensis	470150	S	46	162	208	1244604	0.000037	0.000167
Pseudomonas protegens	380021	S	203	3	206	1244604	0.000163	0.000166
Shigella virus SFN6B	2733607	S	196	10	206	1244604	0.000157	0.000166
Citrobacter sp. RHBSTW-00424	2742647	S	2	201	203	1244604	0.000002	0.000163
Pseudomonas sp. HLS-6	2049589	S	201	2	203	1244604	0.000161	0.000163
Escherichia virus K1G	1911008	S	144	59	203	1244604	0.000116	0.000163
Citrobacter sp. LY-1	2546350	S	182	16	198	1244604	0.000146	0.000159
Escherichia virus HZP2	2733878	S	177	20	197	1244604	0.000142	0.000158
Dickeya virus RC2014	2169973	S	34	163	197	1244604	0.000027	0.000158
Burkholderia cenocepacia	95486	S	110	86	196	1244604	0.000088	0.000157
Escherichia virus Ime09	1914200	S	131	64	195	1244604	0.000105	0.000157
Erwinia virus Alexandra	2734081	S	195	0	195	1244604	0.000157	0.000157
Citrobacter tructae	2562449	S	188	5	193	1244604	0.000151	0.000155
Aeromonas taiwanensis	633417	S	51	142	193	1244604	0.000041	0.000155
Erwinia sp. J780	2681984	S	188	4	192	1244604	0.000151	0.000154
Citrobacter sp. RHBSTW-00903	2742670	S	5	182	187	1244604	0.000004	0.000150
Salmonella virus Vi06	2733882	S	187	0	187	1244604	0.000150	0.000150
Pectobacterium brasiliense	180957	S	151	34	185	1244604	0.000121	0.000149
Citrobacter sp. CF971	2566012	S	31	152	183	1244604	0.000025	0.000147
Klebsiella virus KN4-1	2733673	S	165	18	183	1244604	0.000133	0.000147
Raoultella planticola	575	S	168	11	179	1244604	0.000135	0.000144
Serratia plymuthica	82996	S	164	14	178	1244604	0.000132	0.000143
Shigella dysenteriae	622	S	94	81	175	1244604	0.000076	0.000141
Pseudomonas sp. DG56-2	2320270	S	175	0	175	1244604	0.000141	0.000141
Klebsiella virus BIS33	2733664	S	85	90	175	1244604	0.000068	0.000141
Klebsiella virus KLPN1	1981041	S	122	53	175	1244604	0.000098	0.000141
Shewanella sp. LZH-2	2806008	S	123	50	173	1244604	0.000099	0.000139
Citrobacter sp. LUTT5	2697370	S	24	148	172	1244604	0.000019	0.000138
Lysinibacillus sp. YS11	2072025	S	150	20	170	1244604	0.000121	0.000137
Lelliottia amnigena	61646	S	166	1	167	1244604	0.000133	0.000134
Pseudomonas syringae group genomosp. 3	251701	S	50	115	165	1244604	0.000040	0.000133
Enterobacter virus E3	2732701	S	91	74	165	1244604	0.000073	0.000133
Cronobacter dublinensis	413497	S	148	14	162	1244604	0.000119	0.000130
Klebsiella virus KP36	1920861	S	99	61	160	1244604	0.000080	0.000129
Klebsiella virus 1513	1920862	S	97	63	160	1244604	0.000078	0.000129
Aeromonas sp. 1805	2560028	S	103	56	159	1244604	0.000083	0.000128
Enterobacter cancerogenus	69218	S	157	1	158	1244604	0.000126	0.000127
Erwinia sp. QL-Z3	2547962	S	38	119	157	1244604	0.000031	0.000126
Atlantibacter hermannii	565	S	155	0	155	1244604	0.000125	0.000125
Pseudomonas sp. JY-Q	1338689	S	63	93	156	1244604	0.000051	0.000125
Klebsiella virus Pharr	2733682	S	85	68	153	1244604	0.000068	0.000123
Acinetobacter soli	487316	S	151	1	152	1244604	0.000121	0.000122
Serratia fonticola	47917	S	137	13	150	1244604	0.000110	0.000121
Klebsiella virus K11	1985724	S	122	29	151	1244604	0.000098	0.000121
Klebsiella phage Shelby	2580405	S	91	60	151	1244604	0.000073	0.000121
Serratia rubidaea	61652	S	88	61	149	1244604	0.000071	0.000120
Enterobacter sp. SA187	1914861	S	148	0	148	1244604	0.000119	0.000119
Pseudescherichia vulneris	566	S	148	0	148	1244604	0.000119	0.000119
Aeromonas schubertii	652	S	147	1	148	1244604	0.000118	0.000119
Klebsiella virus KpCol1	2734034	S	70	76	146	1244604	0.000056	0.000117
Serratia ureilytica	300181	S	16	128	144	1244604	0.000013	0.000116
Citrobacter sp. R56	1573676	S	142	1	143	1244604	0.000114	0.000115
Enterobacter sp. E76	2596949	S	136	7	143	1244604	0.000109	0.000115
Kosakonia oryzae	497725	S	104	39	143	1244604	0.000084	0.000115
Cronobacter universalis	535744	S	115	26	141	1244604	0.000092	0.000113
Pseudomonas eucalypticola	2599595	S	141	0	141	1244604	0.000113	0.000113
Jejubacter calystegiae	2579935	S	139	0	139	1244604	0.000112	0.000112
Leclercia sp. 4-9-1-25	2815358	S	136	1	137	1244604	0.000109	0.000110
Kosakonia sp. CCTCC M2018092	2492396	S	88	48	136	1244604	0.000071	0.000109
[Enterobacter] lignolyticus	1334193	S	131	3	134	1244604	0.000105	0.000108
Citrobacter koseri	545	S	85	48	133	1244604	0.000068	0.000107
Xenorhabdus nematophila	628	S	130	3	133	1244604	0.000104	0.000107
Rahnella aquatilis	34038	S	87	46	133	1244604	0.000070	0.000107
Klebsiella phage vB_KpnS_15-38_KLPPOU149	2686209	S	66	67	133	1244604	0.000053	0.000107
Citrobacter sp. RHB25-C09	2742624	S	130	1	131	1244604	0.000104	0.000105
Enterobacter soli	885040	S	130	1	131	1244604	0.000104	0.000105
Pseudomonas sp. B11D7D	2735906	S	131	0	131	1244604	0.000105	0.000105
Citrobacter virus CFP1	2732697	S	70	61	131	1244604	0.000056	0.000105
Dickeya sp. CSL RW240	1224144	S	2	128	130	1244604	0.000002	0.000104
Pseudomonas sp. StFLB209	1028989	S	130	0	130	1244604	0.000104	0.000104
Aeromonas sp. CA23	2033032	S	126	3	129	1244604	0.000101	0.000104
Escherichia sp. E4742	2044467	S	125	3	128	1244604	0.000100	0.000103
Shigella virus Sf24	2560761	S	58	70	128	1244604	0.000047	0.000103
Klebsiella virus Henu1	2733665	S	105	23	128	1244604	0.000084	0.000103
Kluyvera genomosp. 3	2774055	S	125	1	126	1244604	0.000100	0.000101
Enterobacter bugandensis	881260	S	119	4	123	1244604	0.000096	0.000099
Aeromonas sp.	647	S	116	7	123	1244604	0.000093	0.000099
Cronobacter virus GAP31	1914895	S	123	0	123	1244604	0.000099	0.000099
Klebsiella virus TSK1	2734043	S	78	45	123	1244604	0.000063	0.000099
Klebsiella virus KpKT21phi1	2734035	S	56	67	123	1244604	0.000045	0.000099
Enterobacter sp. RHBSTW-00422	2742646	S	14	108	122	1244604	0.000011	0.000098
Pseudomonas azotoformans	47878	S	106	15	121	1244604	0.000085	0.000097
Klebsiella virus SHKp152234	2733684	S	88	33	121	1244604	0.000071	0.000097
Enterobacter chengduensis	2494701	S	112	7	119	1244604	0.000090	0.000096
Pseudomonas alcaligenes	43263	S	117	2	119	1244604	0.000094	0.000096
Aeromonas sp. ASNIH3	1636608	S	13	107	120	1244604	0.000010	0.000096
Aeromonas encheleia	73010	S	118	1	119	1244604	0.000095	0.000096
Shewanella sp. LC6	2589790	S	50	69	119	1244604	0.000040	0.000096
Klebsiella virus KN3-1	2733672	S	103	17	120	1244604	0.000083	0.000096
Kosakonia radicincitans	283686	S	82	36	118	1244604	0.000066	0.000095
Bacillus cereus	1396	S	50	68	118	1244604	0.000040	0.000095
Pseudomonas synxantha	47883	S	96	21	117	1244604	0.000077	0.000094
Citrobacter sp. TSA-1	184912	S	40	76	116	1244604	0.000032	0.000093
Pseudomonas mediterranea	183795	S	107	9	116	1244604	0.000086	0.000093
Erwinia phage vB_EamM_Huxley	1883373	S	27	89	116	1244604	0.000022	0.000093
Citrobacter sp. RHBSTW-00678	2742661	S	3	111	114	1244604	0.000002	0.000092
Enterobacter ludwigii	299767	S	75	39	114	1244604	0.000060	0.000092
Escherichia virus EC6	1965376	S	88	26	114	1244604	0.000071	0.000092
Klebsiella phage KP1801	2678563	S	77	36	113	1244604	0.000062	0.000091
Klebsiella virus GHK3	2734032	S	70	43	113	1244604	0.000056	0.000091
Erwinia tasmaniensis	338565	S	109	3	112	1244604	0.000088	0.000090
Acidovorax antarcticus	2743470	S	109	3	112	1244604	0.000088	0.000090
Klebsiella virus KpV763	2733679	S	80	32	112	1244604	0.000064	0.000090
Enterobacter cloacae complex sp.	2027919	S	63	46	109	1244604	0.000051	0.000088
Dickeya zeae	204042	S	108	1	109	1244604	0.000087	0.000088
Shewanella sp. FDAARGOS_354	1930557	S	38	71	109	1244604	0.000031	0.000088
Klebsiella phage JY917	2099585	S	61	48	109	1244604	0.000049	0.000088
Cedecea lapagei	158823	S	100	8	108	1244604	0.000080	0.000087
Erwinia amylovora	552	S	103	5	108	1244604	0.000083	0.000087
Pseudomonas sp. MSPm1	2726956	S	108	0	108	1244604	0.000087	0.000087
Pseudomonas sp. CMR5c	658630	S	106	2	108	1244604	0.000085	0.000087
Escherichia virus K1ind2	1911009	S	64	44	108	1244604	0.000051	0.000087
Shigella virus Sb1	1920761	S	106	2	108	1244604	0.000085	0.000087
Klebsiella virus IL33	2733666	S	50	57	107	1244604	0.000040	0.000086
Erwinia virus Machina	2169990	S	25	81	106	1244604	0.000020	0.000085
Klebsiella virus K5-2	2733669	S	88	18	106	1244604	0.000071	0.000085
Citrobacter sp. RHBSTW-00021	2742630	S	1	104	105	1244604	0.000001	0.000084
Cedecea sp. FDAARGOS_727	2545798	S	102	3	105	1244604	0.000082	0.000084
Enterobacter virus KPN3	2732702	S	72	32	104	1244604	0.000058	0.000084
Klebsiella virus IME205	2733667	S	89	14	103	1244604	0.000072	0.000083
Lysinibacillus varians	1145276	S	24	78	102	1244604	0.000019	0.000082
Citrobacter sp. BIDMC107	1686384	S	23	78	101	1244604	0.000018	0.000081
Enterobacter sp. JUb54	2724468	S	99	0	99	1244604	0.000080	0.000080
Kurthia sp. 11kri321	1750719	S	97	3	100	1244604	0.000078	0.000080
Citrobacter sp. RHBSTW-00887	2742668	S	35	63	98	1244604	0.000028	0.000079
Citrobacter sp. RHBSTW-00524	2742653	S	32	66	98	1244604	0.000026	0.000079
Raoultella terrigena	577	S	90	8	98	1244604	0.000072	0.000079
Escherichia virus WFH	2734157	S	74	24	98	1244604	0.000059	0.000079
Klebsiella phage Skenny	2580407	S	37	61	98	1244604	0.000030	0.000079
Pseudomonas orientalis	76758	S	91	6	97	1244604	0.000073	0.000078
Shewanella oneidensis	70863	S	96	1	97	1244604	0.000077	0.000078
Kosakonia sp. SMBL-WEM22	2725560	S	82	13	95	1244604	0.000066	0.000076
Kosakonia sacchari	1158459	S	74	20	94	1244604	0.000059	0.000076
Edwardsiella ictaluri	67780	S	94	0	94	1244604	0.000076	0.000076
Pseudomonas sp. TUM18999	2725477	S	94	0	94	1244604	0.000076	0.000076
Shewanella sp. ANA-3	94122	S	71	24	95	1244604	0.000057	0.000076
Cronobacter phage S13	1327935	S	94	0	94	1244604	0.000076	0.000076
Escherichia virus 4MG	1914894	S	95	0	95	1244604	0.000076	0.000076
Escherichia virus EC1UPM	1920760	S	93	1	94	1244604	0.000075	0.000076
Escherichia virus ECBP1	1920758	S	61	34	95	1244604	0.000049	0.000076
Citrobacter freundii complex sp. CFNIH3	2077147	S	3	90	93	1244604	0.000002	0.000075
Cronobacter condimenti	1163710	S	87	6	93	1244604	0.000070	0.000075
Scandinavium goeteborgense	1851514	S	93	0	93	1244604	0.000075	0.000075
Providencia sp. 1701091	2603245	S	1	92	93	1244604	0.000001	0.000075
Pseudomonas balearica	74829	S	83	10	93	1244604	0.000067	0.000075
Pseudomonas brassicacearum	930166	S	63	29	92	1244604	0.000051	0.000074
Escherichia virus HY02	1985308	S	66	26	92	1244604	0.000053	0.000074
Klebsiella virus KpV767	2733681	S	87	5	92	1244604	0.000070	0.000074
Citrobacter farmeri	67824	S	80	9	89	1244604	0.000064	0.000072
Pseudomonas sp. TCU-HL1	1856685	S	90	0	90	1244604	0.000072	0.000072
Stenotrophomonas maltophilia	40324	S	68	21	89	1244604	0.000055	0.000072
Klebsiella virus kpssk3	2733678	S	77	13	90	1244604	0.000062	0.000072
Cronobacter sp. JZ38	1906275	S	28	60	88	1244604	0.000022	0.000071
Shimwellia blattae	563	S	88	0	88	1244604	0.000071	0.000071
Yokenella regensburgei	158877	S	86	1	87	1244604	0.000069	0.000070
Serratia proteamaculans	28151	S	74	13	87	1244604	0.000059	0.000070
Pseudomonas asturiensis	1190415	S	87	0	87	1244604	0.000070	0.000070
Klebsiella virus PRA33	2733683	S	54	33	87	1244604	0.000043	0.000070
Pseudomonas sp. 7SR1	1881017	S	86	0	86	1244604	0.000069	0.000069
Delftia sp. Cs1-4	742013	S	43	43	86	1244604	0.000035	0.000069
Erwinia virus Desertfox	2560433	S	12	74	86	1244604	0.000010	0.000069
Enterobacter sp. RHBSTW-00175	2742639	S	82	3	85	1244604	0.000066	0.000068
Salmonella bongori	54736	S	81	4	85	1244604	0.000065	0.000068
Streptomyces lividans	1916	S	4	81	85	1244604	0.000003	0.000068
Klebsiella sp. LY	2015795	S	23	60	83	1244604	0.000018	0.000067
Pseudomonas frederiksbergensis	104087	S	82	2	84	1244604	0.000066	0.000067
Burkholderia territorii	1503055	S	76	7	83	1244604	0.000061	0.000067
Burkholderia anthina	179879	S	65	18	83	1244604	0.000052	0.000067
Erwinia phage pEp_SNUABM_01	2601643	S	84	0	84	1244604	0.000067	0.000067
Yersinia virus Yen9-04	2560849	S	79	5	84	1244604	0.000063	0.000067
Klebsiella virus KpV766	2733680	S	38	46	84	1244604	0.000031	0.000067
Citrobacter virus SH2	2732699	S	44	39	83	1244604	0.000035	0.000067
Klebsiella phage Sweeny	2580408	S	51	33	84	1244604	0.000041	0.000067
Cronobacter malonaticus	413503	S	56	26	82	1244604	0.000045	0.000066
Pseudomonas rhizosphaerae	216142	S	82	0	82	1244604	0.000066	0.000066
Escherichia phage UFV-AREG1	1837867	S	51	31	82	1244604	0.000041	0.000066
Pseudomonas sp. ADAK22	2730851	S	55	26	81	1244604	0.000044	0.000065
Shigella phage SHFML-26	1863009	S	37	44	81	1244604	0.000030	0.000065
Klebsiella virus SHKp152410	2733685	S	62	19	81	1244604	0.000050	0.000065
Citrobacter sp. RHB36-C18	2742627	S	23	57	80	1244604	0.000018	0.000064
Kosakonia sp. MUSA4	2067958	S	62	18	80	1244604	0.000050	0.000064
Pseudomonas sp. CC6-YY-74	1930532	S	80	0	80	1244604	0.000064	0.000064
Escherichia virus HY01	2049937	S	55	25	80	1244604	0.000044	0.000064
Shigella virus Shfl2	1914205	S	43	37	80	1244604	0.000035	0.000064
Escherichia virus VpaE1	1965382	S	57	23	80	1244604	0.000046	0.000064
Klebsiella phage 13	2488573	S	42	38	80	1244604	0.000034	0.000064
Citrobacter freundii complex sp. CFNIH4	2077148	S	3	75	78	1244604	0.000002	0.000063
Citrobacter sp. RHBSTW-01013	2742677	S	7	71	78	1244604	0.000006	0.000063
Leclercia sp. 29361	2714951	S	77	2	79	1244604	0.000062	0.000063
Pseudomonas tolaasii	29442	S	75	3	78	1244604	0.000060	0.000063
Klebsiella phage Marfa	2587809	S	79	0	79	1244604	0.000063	0.000063
Escherichia virus JH2	1965379	S	52	27	79	1244604	0.000042	0.000063
Escherichia virus ECML-117	2734154	S	63	15	78	1244604	0.000051	0.000063
Escherichia virus FEC19	2734155	S	59	19	78	1244604	0.000047	0.000063
Klebsiella virus K5-4	2733670	S	64	15	79	1244604	0.000051	0.000063
Enterobacter virus E2	2732700	S	37	41	78	1244604	0.000030	0.000063
Hydrogenophaga sp. NH-16	2184519	S	71	6	77	1244604	0.000057	0.000062
Paraclostridium bifermentans	1490	S	77	0	77	1244604	0.000062	0.000062
Shigella phage SHFML-11	1863008	S	34	43	77	1244604	0.000027	0.000062
Klebsiella phage Soft	2601626	S	70	7	77	1244604	0.000056	0.000062
Citrobacter sp. FDAARGOS_156	1702170	S	38	38	76	1244604	0.000031	0.000061
Phytobacter ursingii	1972431	S	70	6	76	1244604	0.000056	0.000061
Pseudomonas psychrotolerans	237610	S	76	0	76	1244604	0.000061	0.000061
Pseudomonas koreensis	198620	S	75	1	76	1244604	0.000060	0.000061
Aeromonas allosaccharophila	656	S	61	15	76	1244604	0.000049	0.000061
Burkholderia multivorans	87883	S	71	5	76	1244604	0.000057	0.000061
Burkholderia ambifaria	152480	S	57	19	76	1244604	0.000046	0.000061
Pseudomonas sp. K2W31S-8	2320867	S	75	0	75	1244604	0.000060	0.000060
Escherichia virus HY03	2560446	S	39	36	75	1244604	0.000031	0.000060
Klebsiella virus NJR15	2734039	S	28	47	75	1244604	0.000022	0.000060
Klebsiella huaxiensis	2153354	S	72	2	74	1244604	0.000058	0.000059
Serratia odorifera	618	S	71	2	73	1244604	0.000057	0.000059
Pseudomonas furukawaii	1149133	S	72	1	73	1244604	0.000058	0.000059
Yersinia virus PST	1914207	S	41	33	74	1244604	0.000033	0.000059
Escherichia virus TP1	1985309	S	25	48	73	1244604	0.000020	0.000059
Yersinia virus YeF10	2732713	S	31	42	73	1244604	0.000025	0.000059
Klebsiella virus NJS2	2734041	S	37	36	73	1244604	0.000030	0.000059
Citrobacter telavivum	2653932	S	66	6	72	1244604	0.000053	0.000058
Citrobacter pasteurii	1563222	S	37	35	72	1244604	0.000030	0.000058
Cupriavidus taiwanensis	164546	S	64	8	72	1244604	0.000051	0.000058
Serratia virus BF	2560751	S	68	4	72	1244604	0.000055	0.000058
Escherichia virus ECB2	1987939	S	71	1	72	1244604	0.000057	0.000058
Enterobacter oligotrophicus	2478464	S	71	0	71	1244604	0.000057	0.000057
Gibbsiella quercinecans	929813	S	69	2	71	1244604	0.000055	0.000057
Escherichia virus RB32	45406	S	34	37	71	1244604	0.000027	0.000057
Klebsiella virus KN1-1	2733671	S	68	3	71	1244604	0.000055	0.000057
Klebsiella virus K5	1985723	S	59	12	71	1244604	0.000047	0.000057
Salmonella virus LSPA1	2005698	S	71	0	71	1244604	0.000057	0.000057
Leclercia sp. LSNIH3	1920116	S	3	67	70	1244604	0.000002	0.000056
Yersinia bercovieri	634	S	41	29	70	1244604	0.000033	0.000056
Escherichia virus ESCO5	2734130	S	5	65	70	1244604	0.000004	0.000056
Yersinia virus AP5	2732712	S	47	23	70	1244604	0.000038	0.000056
Klebsiella sp. STW0522-44	2681387	S	59	9	68	1244604	0.000047	0.000055
Citrobacter sp. RHBSTW-00986	2742675	S	21	48	69	1244604	0.000017	0.000055
Citrobacter sp. RHBSTW-00570	2742655	S	14	55	69	1244604	0.000011	0.000055
Pseudomonas sp. S1-A32-2	2731681	S	69	0	69	1244604	0.000055	0.000055
Pseudomonas sp. SDM007	2812000	S	66	3	69	1244604	0.000053	0.000055
Pseudomonas migulae	78543	S	67	2	69	1244604	0.000054	0.000055
Pseudomonas cichorii	36746	S	69	0	69	1244604	0.000055	0.000055
Escherichia virus E112	1914201	S	34	34	68	1244604	0.000027	0.000055
Escherichia virus AYO145A	1965378	S	48	21	69	1244604	0.000039	0.000055
Escherichia virus WFC	2734156	S	61	8	69	1244604	0.000049	0.000055
Citrobacter virus SH1	2732698	S	42	27	69	1244604	0.000034	0.000055
Salmonella virus SG-JL2	2732709	S	41	28	69	1244604	0.000033	0.000055
Pseudomonas umsongensis	198618	S	66	0	66	1244604	0.000053	0.000053
Chryseobacterium bernardetii	1241978	S	53	13	66	1244604	0.000043	0.000053
Citrobacter virus SH3	2733631	S	57	9	66	1244604	0.000046	0.000053
Klebsiella phage Sin4	2580406	S	57	9	66	1244604	0.000046	0.000053
Kluyvera intermedia	61648	S	63	2	65	1244604	0.000051	0.000052
Serratia liquefaciens	614	S	47	18	65	1244604	0.000038	0.000052
Yersinia pestis	632	S	7	58	65	1244604	0.000006	0.000052
Pseudomonas yamanorum	515393	S	65	0	65	1244604	0.000052	0.000052
Vibrio fluvialis	676	S	63	2	65	1244604	0.000051	0.000052
Variovorax paradoxus	34073	S	57	8	65	1244604	0.000046	0.000052
Burkholderia latens	488446	S	38	27	65	1244604	0.000031	0.000052
Escherichia virus F	2733637	S	29	36	65	1244604	0.000023	0.000052
Klebsiella phage Seifer	2315475	S	62	3	65	1244604	0.000050	0.000052
Citrobacter sp. RHBSTW-00599	2742657	S	19	45	64	1244604	0.000015	0.000051
Leclercia sp. 1106151	2681309	S	14	50	64	1244604	0.000011	0.000051
Erwinia pyrifoliae	79967	S	29	34	63	1244604	0.000023	0.000051
Ewingella americana	41202	S	61	2	63	1244604	0.000049	0.000051
Achromobacter ruhlandii	72557	S	46	18	64	1244604	0.000037	0.000051
Clostridium botulinum	1491	S	52	11	63	1244604	0.000042	0.000051
Erwinia virus Deimos	1984777	S	12	52	64	1244604	0.000010	0.000051
Klebsiella virus Kp1	1985725	S	50	13	63	1244604	0.000040	0.000051
Salmonella phage pertopsoe	2713310	S	32	31	63	1244604	0.000026	0.000051
Klebsiella virus MezzoGao	2734038	S	19	44	63	1244604	0.000015	0.000051
Yersinia enterocolitica	630	S	61	1	62	1244604	0.000049	0.000050
Brenneria rubrifaciens	55213	S	37	25	62	1244604	0.000030	0.000050
Pseudomonas sp. ABC1	2748080	S	62	0	62	1244604	0.000050	0.000050
Pseudomonas nitroreducens	46680	S	57	5	62	1244604	0.000046	0.000050
Pseudomonas lalkuanensis	2604832	S	62	0	62	1244604	0.000050	0.000050
Acidovorax avenae	80867	S	58	4	62	1244604	0.000047	0.000050
Burkholderia vietnamiensis	60552	S	21	41	62	1244604	0.000017	0.000050
Burkholderia dolosa	152500	S	1	61	62	1244604	0.000001	0.000050
Salmonella virus BPS17L1	2560724	S	42	20	62	1244604	0.000034	0.000050
Salmonella phage Se-J	2698910	S	31	31	62	1244604	0.000025	0.000050
Kosakonia arachidis	551989	S	59	2	61	1244604	0.000047	0.000049
Kosakonia pseudosacchari	1646340	S	52	9	61	1244604	0.000042	0.000049
Cronobacter muytjensii	413501	S	17	44	61	1244604	0.000014	0.000049
Buchnera aphidicola	9	S	61	0	61	1244604	0.000049	0.000049
Serratia symbiotica	138074	S	61	0	61	1244604	0.000049	0.000049
Salmonella phage SAP012	2742114	S	61	0	61	1244604	0.000049	0.000049
Leclercia sp. J807	2681307	S	35	25	60	1244604	0.000028	0.000048
Brenneria sp. Ir50	2722756	S	34	26	60	1244604	0.000027	0.000048
Escherichia virus wV8	1965385	S	20	40	60	1244604	0.000016	0.000048
Erwinia virus Y3	2734143	S	60	0	60	1244604	0.000048	0.000048
Escherichia virus PE3-1	2733642	S	52	8	60	1244604	0.000042	0.000048
Escherichia virus Bp4	1920757	S	41	19	60	1244604	0.000033	0.000048
Citrobacter sp. 172116965	2683822	S	16	42	58	1244604	0.000013	0.000047
Enterobacter sp. 638	399742	S	59	0	59	1244604	0.000047	0.000047
Enterobacter sp. RHBSTW-00994	2742676	S	58	0	58	1244604	0.000047	0.000047
Buttiauxella agrestis	82977	S	54	4	58	1244604	0.000043	0.000047
Tatumella ptyseos	82987	S	54	4	58	1244604	0.000043	0.000047
Yersinia kristensenii	28152	S	24	35	59	1244604	0.000019	0.000047
Hafnia alvei	569	S	39	19	58	1244604	0.000031	0.000047
Pseudomonas sp. DY-1	1755504	S	59	0	59	1244604	0.000047	0.000047
Pseudomonas knackmussii	65741	S	59	0	59	1244604	0.000047	0.000047
Aeromonas sp. CU5	2033033	S	58	1	59	1244604	0.000047	0.000047
Paenibacillus sp. JZ16	1906272	S	57	1	58	1244604	0.000046	0.000047
Escherichia virus T4	10665	S	38	21	59	1244604	0.000031	0.000047
Shigella virus Sf21	2560759	S	24	35	59	1244604	0.000019	0.000047
Escherichia virus Alf5	2560439	S	42	17	59	1244604	0.000034	0.000047
Salmonella virus BPS17W1	2560725	S	40	19	59	1244604	0.000032	0.000047
Klebsiella virus IME321	2733668	S	50	9	59	1244604	0.000040	0.000047
Shigella virus SFPH2	2733647	S	50	9	59	1244604	0.000040	0.000047
Citrobacter virus SH4	2733632	S	43	15	58	1244604	0.000035	0.000047
Escherichia virus K1F	2733640	S	37	21	58	1244604	0.000030	0.000047
Klebsiella virus Sushi	1981043	S	22	37	59	1244604	0.000018	0.000047
Rouxiella badensis	1646377	S	57	0	57	1244604	0.000046	0.000046
Pseudomonas sp. SCB32	2653853	S	57	0	57	1244604	0.000046	0.000046
Pseudomonas sp. phDV1	253237	S	45	12	57	1244604	0.000036	0.000046
Pseudomonas savastanoi	29438	S	8	49	57	1244604	0.000006	0.000046
Erwinia virus Simmy50	1984780	S	8	49	57	1244604	0.000006	0.000046
Buttiauxella sp. 3AFRM03	2479367	S	53	3	56	1244604	0.000043	0.000045
Pseudomonas denitrificans (nom. rej.)	43306	S	56	0	56	1244604	0.000045	0.000045
Alcaligenes faecalis	511	S	53	3	56	1244604	0.000043	0.000045
Pectinobacterium virus CBB	2560628	S	56	0	56	1244604	0.000045	0.000045
Cronobacter virus Dev2	2733633	S	44	12	56	1244604	0.000035	0.000045
Escherichia virus IME11	1920759	S	56	0	56	1244604	0.000045	0.000045
Tatumella citrea	53336	S	52	3	55	1244604	0.000042	0.000044
Pseudomonas veronii	76761	S	40	15	55	1244604	0.000032	0.000044
Vibrio cholerae	666	S	41	14	55	1244604	0.000033	0.000044
Diaphorobacter sp. JS3051	2792224	S	24	31	55	1244604	0.000019	0.000044
Enterobacter sp. RHBSTW-00975	2742673	S	30	23	53	1244604	0.000024	0.000043
Serratia sp. FDAARGOS_506	2420306	S	45	8	53	1244604	0.000036	0.000043
Serratia surfactantfaciens	2741499	S	47	6	53	1244604	0.000038	0.000043
Pseudomonas sp. R2-60-08W	1173280	S	20	33	53	1244604	0.000016	0.000043
Pseudomonas oleovorans	301	S	38	15	53	1244604	0.000031	0.000043
Pseudomonas poae	200451	S	47	6	53	1244604	0.000038	0.000043
Pseudomonas lundensis	86185	S	54	0	54	1244604	0.000043	0.000043
Acinetobacter pittii	48296	S	34	19	53	1244604	0.000027	0.000043
Acidovorax carolinensis	553814	S	48	6	54	1244604	0.000039	0.000043
Solibacillus sp. R5-41	2048654	S	53	1	54	1244604	0.000043	0.000043
Staphylococcus cohnii	29382	S	42	11	53	1244604	0.000034	0.000043
Salmonella virus Si3	2560735	S	19	34	53	1244604	0.000015	0.000043
Yersinia phage phiA1122	227720	S	7	46	53	1244604	0.000006	0.000043
Klebsiella virus KpV289	1985727	S	27	27	54	1244604	0.000022	0.000043
Klebsiella phage PhiKpNIH-2	2689114	S	42	11	53	1244604	0.000034	0.000043
Klebsiella phage vB_KpnS_SegesCirculi	2591374	S	24	29	53	1244604	0.000019	0.000043
Dickeya dadantii	204038	S	51	1	52	1244604	0.000041	0.000042
Aeromonas sobria	646	S	37	15	52	1244604	0.000030	0.000042
Shewanella decolorationis	256839	S	48	4	52	1244604	0.000039	0.000042
Bordetella avium	521	S	52	0	52	1244604	0.000042	0.000042
Candidatus Hamiltonella defensa	138072	S	51	0	51	1244604	0.000041	0.000041
Dickeya chrysanthemi	556	S	51	0	51	1244604	0.000041	0.000041
Acidovorax citrulli	80869	S	42	9	51	1244604	0.000034	0.000041
Burkholderia thailandensis	57975	S	7	44	51	1244604	0.000006	0.000041
Edwardsiella phage PEi20	1608310	S	51	0	51	1244604	0.000041	0.000041
Salmonella virus BPS15Q2	2560723	S	30	21	51	1244604	0.000024	0.000041
Klebsiella phage vB_KpnS_FZ10	2530029	S	32	19	51	1244604	0.000026	0.000041
Kluyvera cryocrescens	580	S	2	48	50	1244604	0.000002	0.000040
Serratia sp. 1D1416	2447890	S	17	33	50	1244604	0.000014	0.000040
Pseudomonas sp. ADAK13	2730847	S	50	0	50	1244604	0.000040	0.000040
Pseudomonas sp. PDNC002	2811422	S	50	0	50	1244604	0.000040	0.000040
Pseudomonas saudiphocaensis	1499686	S	50	0	50	1244604	0.000040	0.000040
Pseudomonas agarici	46677	S	50	0	50	1244604	0.000040	0.000040
Klebsiella phage KL	2608376	S	30	20	50	1244604	0.000024	0.000040
Enterobacter mori	539813	S	34	15	49	1244604	0.000027	0.000039
Pseudomonas citronellolis	53408	S	43	5	48	1244604	0.000035	0.000039
Pseudomonas rhodesiae	76760	S	47	2	49	1244604	0.000038	0.000039
Pseudomonas marincola	437900	S	49	0	49	1244604	0.000039	0.000039
Pseudomonas guangdongensis	1245526	S	48	0	48	1244604	0.000039	0.000039
Ralstonia solanacearum	305	S	35	13	48	1244604	0.000028	0.000039
Enterobacteria phage RB27	69609	S	18	31	49	1244604	0.000014	0.000039
Cronobacter virus GAP32	2560400	S	49	0	49	1244604	0.000039	0.000039
Stenotrophomonas virus IME15	2733883	S	49	0	49	1244604	0.000039	0.000039
Escherichia virus ST31	2733644	S	39	10	49	1244604	0.000031	0.000039
Salmonella virus SP101	2005693	S	48	1	49	1244604	0.000039	0.000039
Citrobacter sp. CFNIH10	1920110	S	14	33	47	1244604	0.000011	0.000038
Rahnella sp. ERMR1:05	1805933	S	47	0	47	1244604	0.000038	0.000038
Pseudomonas sp. LAB-08	143813	S	47	0	47	1244604	0.000038	0.000038
Vibrio anguillarum	55601	S	45	2	47	1244604	0.000036	0.000038
Comamonas piscis	1562974	S	47	0	47	1244604	0.000038	0.000038
Erwinia virus SpecialG	1984781	S	12	35	47	1244604	0.000010	0.000038
Escherichia virus LL2	2732705	S	35	12	47	1244604	0.000028	0.000038
Escherichia virus EcoDS1	2733636	S	45	2	47	1244604	0.000036	0.000038
Escherichia virus UAB78	2733587	S	24	23	47	1244604	0.000019	0.000038
Serratia grimesii	82995	S	45	1	46	1244604	0.000036	0.000037
Pseudomonas sp. S34	1573718	S	46	0	46	1244604	0.000037	0.000037
Pseudomonas libanensis	75588	S	31	15	46	1244604	0.000025	0.000037
Pseudomonas coronafaciens	53409	S	46	0	46	1244604	0.000037	0.000037
Escherichia virus RB14	1914209	S	20	26	46	1244604	0.000016	0.000037
Escherichia virus ZG49	2733646	S	28	18	46	1244604	0.000022	0.000037
Citrobacter sp. RHBSTW-00696	2742662	S	4	41	45	1244604	0.000003	0.000036
Enterobacter sp. CRENT-193	2051905	S	1	44	45	1244604	0.000001	0.000036
Serratia sp. FGI94	671990	S	35	10	45	1244604	0.000028	0.000036
Lonsdalea britannica	1082704	S	40	5	45	1244604	0.000032	0.000036
Pseudomonas sp. LPH1	1898684	S	41	4	45	1244604	0.000033	0.000036
Pseudomonas antarctica	219572	S	45	0	45	1244604	0.000036	0.000036
Pseudomonas extremaustralis	359110	S	45	0	45	1244604	0.000036	0.000036
Pseudomonas moraviensis	321662	S	44	1	45	1244604	0.000035	0.000036
Acidovorax sp. 1608163	2478662	S	44	1	45	1244604	0.000035	0.000036
Acidovorax sp. JMULE5	2518343	S	42	3	45	1244604	0.000034	0.000036
Burkholderia lata	482957	S	41	4	45	1244604	0.000033	0.000036
Pandoraea apista	93218	S	43	2	45	1244604	0.000035	0.000036
Salmonella virus FelixO1	1985310	S	19	26	45	1244604	0.000015	0.000036
Escherichia virus K30	1985722	S	44	1	45	1244604	0.000035	0.000036
Yersinia virus YeO3-12	2732714	S	25	20	45	1244604	0.000020	0.000036
Leclercia virus 10164-302	2732708	S	24	21	45	1244604	0.000019	0.000036
Escherichia virus Vec13	2282173	S	30	15	45	1244604	0.000024	0.000036
Lelliottia nimipressuralis	69220	S	42	2	44	1244604	0.000034	0.000035
Pectobacterium aroidearum	1201031	S	29	14	43	1244604	0.000023	0.000035
Pseudomonas sp. S-6-2	1931241	S	44	0	44	1244604	0.000035	0.000035
Pseudomonas viridiflava	33069	S	44	0	44	1244604	0.000035	0.000035
Pseudomonas fragi	296	S	40	4	44	1244604	0.000032	0.000035
Pseudomonas thivervalensis	86265	S	44	0	44	1244604	0.000035	0.000035
Pseudomonas reinekei	395598	S	43	0	43	1244604	0.000035	0.000035
Escherichia virus RB3	1914203	S	15	28	43	1244604	0.000012	0.000035
Escherichia virus ECA2	2732704	S	26	18	44	1244604	0.000021	0.000035
Escherichia virus APEC7	1920755	S	32	11	43	1244604	0.000026	0.000035
Klebsiella virus TAH8	2734042	S	15	29	44	1244604	0.000012	0.000035
Citrobacter sp. RHBSTW-01044	2742678	S	10	32	42	1244604	0.000008	0.000034
Citrobacter sp. RHBSTW-00821	2742663	S	1	41	42	1244604	0.000001	0.000034
Pseudomonas mucidolens	46679	S	41	1	42	1244604	0.000033	0.000034
Pseudomonas corrugata	47879	S	40	2	42	1244604	0.000032	0.000034
Pseudomonas trivialis	200450	S	39	3	42	1244604	0.000031	0.000034
Pseudomonas vancouverensis	95300	S	42	0	42	1244604	0.000034	0.000034
Vulcanisaeta distributa	164451	S	42	0	42	1244604	0.000034	0.000034
Escherichia virus YZ1	2733645	S	27	15	42	1244604	0.000022	0.000034
Escherichia virus G7C	1920754	S	42	0	42	1244604	0.000034	0.000034
Klebsiella virus KPN N141	2734036	S	17	25	42	1244604	0.000014	0.000034
Pseudomonas oryzae	1392877	S	41	0	41	1244604	0.000033	0.000033
Pseudomonas arsenicoxydans	702115	S	41	0	41	1244604	0.000033	0.000033
Salmonella virus UAB87	1965383	S	27	14	41	1244604	0.000022	0.000033
Klebsiella sp. WP8-S18-ESBL-06	2675726	S	20	20	40	1244604	0.000016	0.000032
Kluyvera ascorbata	51288	S	34	6	40	1244604	0.000027	0.000032
Chania multitudinisentens	1639108	S	40	0	40	1244604	0.000032	0.000032
Dickeya dianthicola	204039	S	39	1	40	1244604	0.000031	0.000032
Pseudomonas fuscovaginae	50340	S	39	1	40	1244604	0.000031	0.000032
Salmonella virus Jersey	2005696	S	40	0	40	1244604	0.000032	0.000032
Klebsiella virus NJS1	2734040	S	17	23	40	1244604	0.000014	0.000032
Citrobacter freundii complex sp. CFNIH2	2066049	S	29	9	38	1244604	0.000023	0.000031
Citrobacter sp. RHBSTW-00229	2742641	S	2	36	38	1244604	0.000002	0.000031
Citrobacter sp. TBCP-5362	2576406	S	1	38	39	1244604	0.000001	0.000031
Erwinia sp. Ejp617	215689	S	17	22	39	1244604	0.000014	0.000031
Serratia sp. KUDC3025	2597702	S	30	8	38	1244604	0.000024	0.000031
Edwardsiella piscicida	1263550	S	36	2	38	1244604	0.000029	0.000031
Pseudomonas sp. ADAK18	2730848	S	38	0	38	1244604	0.000031	0.000031
Pseudomonas sp. LPB0260	2614442	S	38	0	38	1244604	0.000031	0.000031
Pseudomonas multiresinivorans	95301	S	35	3	38	1244604	0.000028	0.000031
Pseudomonas psychrophila	122355	S	39	0	39	1244604	0.000031	0.000031
Pseudomonas taetrolens	47884	S	38	0	38	1244604	0.000031	0.000031
Pseudomonas graminis	158627	S	38	0	38	1244604	0.000031	0.000031
Pseudomonas sihuiensis	1274359	S	36	3	39	1244604	0.000029	0.000031
Delftia sp. HK171	1920191	S	18	20	38	1244604	0.000014	0.000031
Escherichia virus ECML134	1914202	S	21	18	39	1244604	0.000017	0.000031
Shigella virus SHBML501	2560754	S	17	22	39	1244604	0.000014	0.000031
Serratia virus SM9-3Y	2732711	S	23	16	39	1244604	0.000018	0.000031
Escherichia virus IMM002	2733639	S	38	0	38	1244604	0.000031	0.000031
Escherichia virus LM33P1	2733641	S	31	7	38	1244604	0.000025	0.000031
Salmonella phage aagejoakim	2713273	S	14	24	38	1244604	0.000011	0.000031
Salmonella phage allotria	2713274	S	9	29	38	1244604	0.000007	0.000031
Enterobacter virus F20	1095076	S	39	0	39	1244604	0.000031	0.000031
Enterobacter sp. RHB15-C17	2742619	S	36	1	37	1244604	0.000029	0.000030
Yersinia frederiksenii	29484	S	12	25	37	1244604	0.000010	0.000030
Pseudomonas sp. Tri1	2823875	S	37	0	37	1244604	0.000030	0.000030
Pseudomonas alcaliphila	101564	S	35	2	37	1244604	0.000028	0.000030
Burkholderia ubonensis	101571	S	28	9	37	1244604	0.000022	0.000030
Salmonella phage maane	2713304	S	7	30	37	1244604	0.000006	0.000030
Escherichia virus PhaxI	1987987	S	22	15	37	1244604	0.000018	0.000030
Leclercia sp. 119287	2681308	S	22	14	36	1244604	0.000018	0.000029
Candidatus Erwinia haradaeae	1922217	S	36	0	36	1244604	0.000029	0.000029
Pectobacterium parmentieri	1905730	S	35	1	36	1244604	0.000028	0.000029
Pseudomonas simiae	321846	S	36	0	36	1244604	0.000029	0.000029
Pseudomonas lini	163011	S	36	0	36	1244604	0.000029	0.000029
Pseudomonas versuta	1788301	S	36	0	36	1244604	0.000029	0.000029
Acinetobacter junii	40215	S	36	0	36	1244604	0.000029	0.000029
Acidovorax sp. KKS102	358220	S	32	4	36	1244604	0.000026	0.000029
Burkholderia stabilis	95485	S	32	4	36	1244604	0.000026	0.000029
Bacillus subtilis	1423	S	12	24	36	1244604	0.000010	0.000029
Viridibacillus sp. JNUCC-6	2779527	S	36	0	36	1244604	0.000029	0.000029
Erwinia phage Hena1	2678601	S	36	0	36	1244604	0.000029	0.000029
Staphylococcus phage SA1	694060	S	15	21	36	1244604	0.000012	0.000029
Citrobacter virus CR44b	2733630	S	35	1	36	1244604	0.000028	0.000029
Serratia sp. ATCC 39006	104623	S	35	0	35	1244604	0.000028	0.000028
Serratia sp. LS-1	2485839	S	4	31	35	1244604	0.000003	0.000028
Dickeya paradisiaca	69223	S	35	0	35	1244604	0.000028	0.000028
Pseudomonas sp. MPC6	2498848	S	35	0	35	1244604	0.000028	0.000028
Pseudomonas cedrina	651740	S	32	3	35	1244604	0.000026	0.000028
Lysinibacillus sp. 2017	2169540	S	34	1	35	1244604	0.000027	0.000028
Escherichia virus GA2A	2733638	S	34	1	35	1244604	0.000027	0.000028
Klebsiella phage vB_KpnS_IMGroot	2591375	S	17	18	35	1244604	0.000014	0.000028
Klebsiella sp. FDAARGOS_511	2488567	S	6	28	34	1244604	0.000005	0.000027
Klebsiella sp. WP3-W18-ESBL-02	2675710	S	4	30	34	1244604	0.000003	0.000027
Enterobacter sp. 247	1632810	S	1	33	34	1244604	0.000001	0.000027
Raoultella electrica	1259973	S	30	4	34	1244604	0.000024	0.000027
Serratia sp. CMO1	2785630	S	4	30	34	1244604	0.000003	0.000027
Pectobacterium polaris	2042057	S	30	3	33	1244604	0.000024	0.000027
Sodalis praecaptivus	1239307	S	21	13	34	1244604	0.000017	0.000027
Candidatus Sodalis pierantonius	1486991	S	21	13	34	1244604	0.000017	0.000027
Pseudomonas sp. DTU12.3	2073078	S	34	0	34	1244604	0.000027	0.000027
Pseudomonas sp. ATCC 13867	1294143	S	33	0	33	1244604	0.000027	0.000027
Pseudomonas sp. OIL-1	2706126	S	33	0	33	1244604	0.000027	0.000027
Pseudomonas sp. S35	1573719	S	33	0	33	1244604	0.000027	0.000027
Pseudomonas sp. UW4	1207075	S	31	2	33	1244604	0.000025	0.000027
Pseudomonas sp. 09C 129	2054915	S	29	4	33	1244604	0.000023	0.000027
Pseudomonas sp. BIOMIG1BAC	1758730	S	21	13	34	1244604	0.000017	0.000027
Pseudomonas lurida	244566	S	33	0	33	1244604	0.000027	0.000027
Pseudomonas granadensis	1421430	S	33	1	34	1244604	0.000027	0.000027
Vibrio nigripulchritudo	28173	S	34	0	34	1244604	0.000027	0.000027
Vibrio metoecus	1481663	S	30	4	34	1244604	0.000024	0.000027
Escherichia phage slur07	1720500	S	14	19	33	1244604	0.000011	0.000027
Escherichia phage wV7	1054480	S	11	22	33	1244604	0.000009	0.000027
Shigella virus Sf22	2560760	S	14	19	33	1244604	0.000011	0.000027
Escherichia virus CF2	2560441	S	10	24	34	1244604	0.000008	0.000027
Salmonella virus Mushroom	1965380	S	14	20	34	1244604	0.000011	0.000027
Salmonella phage rabagast	2713314	S	5	29	34	1244604	0.000004	0.000027
Salmonella virus SH19	1987989	S	14	19	33	1244604	0.000011	0.000027
Enterobacter sp. R4-368	1166130	S	30	2	32	1244604	0.000024	0.000026
Leclercia sp. W17	2282309	S	15	17	32	1244604	0.000012	0.000026
Pseudomonas sp. 15A4	2804761	S	32	0	32	1244604	0.000026	0.000026
Pseudomonas sp. R84	1573712	S	31	1	32	1244604	0.000025	0.000026
Pseudomonas sp. R76	1573711	S	31	1	32	1244604	0.000025	0.000026
Pseudomonas sp. St29	1500687	S	21	11	32	1244604	0.000017	0.000026
Pseudomonas viciae	2505979	S	32	0	32	1244604	0.000026	0.000026
Pseudomonas litoralis	797277	S	32	0	32	1244604	0.000026	0.000026
Vibrio vulnificus	672	S	32	0	32	1244604	0.000026	0.000026
Diaphorobacter ruginosibacter	1715720	S	32	0	32	1244604	0.000026	0.000026
Bordetella pertussis	520	S	16	16	32	1244604	0.000013	0.000026
Rhizobium sp. S41	1869170	S	3	29	32	1244604	0.000002	0.000026
Enterobacter sp. 18A13	2565914	S	20	11	31	1244604	0.000016	0.000025
Serratia sp. JUb9	2724469	S	7	24	31	1244604	0.000006	0.000025
Brenneria goodwinii	1109412	S	17	14	31	1244604	0.000014	0.000025
Pseudomonas sp. LG1E9	2219057	S	31	0	31	1244604	0.000025	0.000025
Pseudomonas sp. R5-89-07	658644	S	30	1	31	1244604	0.000024	0.000025
Pseudomonas sp. LG1D9	2083054	S	17	14	31	1244604	0.000014	0.000025
Pseudomonas extremorientalis	169669	S	26	5	31	1244604	0.000021	0.000025
Pseudomonas prosekii	1148509	S	31	0	31	1244604	0.000025	0.000025
Aeromonas rivipollensis	948519	S	24	7	31	1244604	0.000019	0.000025
Comamonas koreensis	160825	S	31	0	31	1244604	0.000025	0.000025
Hydrogenophaga pseudoflava	47421	S	30	1	31	1244604	0.000024	0.000025
Rhodoferax saidenbachensis	1484693	S	31	0	31	1244604	0.000025	0.000025
Burkholderia contaminans	488447	S	27	4	31	1244604	0.000022	0.000025
Bacillus thuringiensis	1428	S	15	16	31	1244604	0.000012	0.000025
Paraliobacillus zengyii	2213194	S	31	0	31	1244604	0.000025	0.000025
Yersinia virus D1	1914208	S	12	19	31	1244604	0.000010	0.000025
Escherichia virus CC31	1913656	S	30	1	31	1244604	0.000024	0.000025
Citrobacter sp. RHBSTW-00535	2742654	S	1	29	30	1244604	0.000001	0.000024
Dickeya fangzhongdai	1778540	S	25	5	30	1244604	0.000020	0.000024
Burkholderia diffusa	488732	S	28	2	30	1244604	0.000022	0.000024
Burkholderia gladioli	28095	S	30	0	30	1244604	0.000024	0.000024
Ralstonia pickettii	329	S	22	8	30	1244604	0.000018	0.000024
Salmonella virus SP116	2560733	S	22	8	30	1244604	0.000018	0.000024
Escherichia phage vB_vPM_PD06	2315527	S	2	28	30	1244604	0.000002	0.000024
Enterobacter cloacae complex sp. FDA-CDC-AR_0164	2077136	S	11	18	29	1244604	0.000009	0.000023
Serratia sp. JKS000199	1938820	S	3	26	29	1244604	0.000002	0.000023
Pseudomonas sp. 31-12	2201356	S	29	0	29	1244604	0.000023	0.000023
Pseudomonas asplenii	53407	S	28	1	29	1244604	0.000022	0.000023
Burkholderia seminalis	488731	S	27	2	29	1244604	0.000022	0.000023
Achromobacter xylosoxidans	85698	S	29	0	29	1244604	0.000023	0.000023
Salmonella virus SETP3	2005700	S	24	5	29	1244604	0.000019	0.000023
Klebsiella sp. WP4-W18-ESBL-05	2675713	S	4	24	28	1244604	0.000003	0.000022
Citrobacter sp. RHB35-C21	2742626	S	9	18	27	1244604	0.000007	0.000022
Escherichia sp. SCLE84	2725997	S	4	23	27	1244604	0.000003	0.000022
Enterobacter sp. N18-03635	2500132	S	24	4	28	1244604	0.000019	0.000022
Pseudomonas sp. S09G 359	2054919	S	28	0	28	1244604	0.000022	0.000022
Pseudomonas sp. NIBRBAC000502773	2590776	S	26	1	27	1244604	0.000021	0.000022
Pseudomonas sp. MRSN12121	1611770	S	24	3	27	1244604	0.000019	0.000022
Pseudomonas brenneri	129817	S	27	1	28	1244604	0.000022	0.000022
Pseudomonas pohangensis	364197	S	28	0	28	1244604	0.000022	0.000022
Pseudomonas silesiensis	1853130	S	28	0	28	1244604	0.000022	0.000022
Vibrio parahaemolyticus	670	S	25	3	28	1244604	0.000020	0.000022
Diaphorobacter sp. HDW4A	2714924	S	26	1	27	1244604	0.000021	0.000022
Enterococcus faecalis	1351	S	24	4	28	1244604	0.000019	0.000022
Enterobacter virus PG7	1913655	S	26	1	27	1244604	0.000021	0.000022
Salmonella virus STML198	1913657	S	7	21	28	1244604	0.000006	0.000022
Salmonella virus PVPSE1	2560728	S	15	13	28	1244604	0.000012	0.000022
Salmonella virus BP12B	2733588	S	13	14	27	1244604	0.000010	0.000022
Escherichia virus APEC5	1920756	S	21	7	28	1244604	0.000017	0.000022
Citrobacter sp. RHBSTW-00881	2742667	S	9	17	26	1244604	0.000007	0.000021
Enterobacter cloacae complex sp. ECNIH7	1915310	S	11	15	26	1244604	0.000009	0.000021
Pseudomonas sp. ACM7	2052956	S	26	0	26	1244604	0.000021	0.000021
Pseudomonas sp. SXM-1	2169583	S	17	9	26	1244604	0.000014	0.000021
Pseudomonas palleroniana	191390	S	26	0	26	1244604	0.000021	0.000021
Acidovorax sp. HDW3	2714923	S	26	0	26	1244604	0.000021	0.000021
Acidovorax monticola	1926868	S	26	0	26	1244604	0.000021	0.000021
Burkholderia sp. MSMB0856	1637869	S	21	5	26	1244604	0.000017	0.000021
[Arcobacter] porcinus	1935204	S	11	15	26	1244604	0.000009	0.000021
Priestia megaterium	1404	S	13	13	26	1244604	0.000010	0.000021
Escherichia phage vB_EcoM-UFV13	1815590	S	14	12	26	1244604	0.000011	0.000021
Escherichia phage muut	2696426	S	8	18	26	1244604	0.000006	0.000021
Shigella virus A7	2732785	S	20	6	26	1244604	0.000016	0.000021
Escherichia virus C	2733585	S	7	19	26	1244604	0.000006	0.000021
Salmonella virus 9NA	1921123	S	21	5	26	1244604	0.000017	0.000021
Serratia sp. SCBI	488142	S	6	19	25	1244604	0.000005	0.000020
Serratia sp. Tan611	2773264	S	6	19	25	1244604	0.000005	0.000020
Serratia quinivorans	137545	S	17	8	25	1244604	0.000014	0.000020
Hafnia paralvei	546367	S	25	0	25	1244604	0.000020	0.000020
Pseudomonas toyotomiensis	554344	S	23	2	25	1244604	0.000018	0.000020
Alicycliphilus denitrificans	179636	S	22	3	25	1244604	0.000018	0.000020
Burkholderia pyrrocinia	60550	S	23	2	25	1244604	0.000018	0.000020
Bradyrhizobium sp. TM102	2599819	S	10	15	25	1244604	0.000008	0.000020
Chlamydia psittaci	83554	S	18	7	25	1244604	0.000014	0.000020
Escherichia virus AR1	1914199	S	7	18	25	1244604	0.000006	0.000020
Cronobacter virus GW1	2733634	S	24	1	25	1244604	0.000019	0.000020
Salmonella virus SP6	194966	S	24	1	25	1244604	0.000019	0.000020
Klebsiella virus IME260	2560539	S	17	8	25	1244604	0.000014	0.000020
Pectobacterium atrosepticum	29471	S	24	0	24	1244604	0.000019	0.000019
Pseudomonas sp. M30-35	1981174	S	24	0	24	1244604	0.000019	0.000019
Pseudomonas sp. gcc21	2726989	S	24	0	24	1244604	0.000019	0.000019
Pseudomonas sp. Z003-0.4C(8344-21)	1855380	S	23	1	24	1244604	0.000018	0.000019
Pseudomonas sp. RU47	2005388	S	15	9	24	1244604	0.000012	0.000019
Pseudomonas allokribbensis	2774460	S	24	0	24	1244604	0.000019	0.000019
Shewanella bicestrii	2018305	S	17	7	24	1244604	0.000014	0.000019
Photobacterium damselae	38293	S	23	1	24	1244604	0.000018	0.000019
Hydrogenophaga sp. BA0156	2716225	S	24	0	24	1244604	0.000019	0.000019
Burkholderia metallica	488729	S	23	1	24	1244604	0.000018	0.000019
Rhodopseudomonas palustris	1076	S	23	1	24	1244604	0.000018	0.000019
Calothrix sp. NIES-3974	2005462	S	24	0	24	1244604	0.000019	0.000019
Escherichia virus Ro45lw	2733643	S	24	0	24	1244604	0.000019	0.000019
Dickeya solani	1089444	S	23	0	23	1244604	0.000018	0.000018
Lonsdalea populi	1172565	S	20	2	22	1244604	0.000016	0.000018
Leminorella richardii	158841	S	23	0	23	1244604	0.000018	0.000018
Pseudomonas luteola	47886	S	23	0	23	1244604	0.000018	0.000018
Acinetobacter sp. NEB 394	2743575	S	12	10	22	1244604	0.000010	0.000018
Shewanella putrefaciens	24	S	14	8	22	1244604	0.000011	0.000018
Psychromonas ingrahamii	357794	S	23	0	23	1244604	0.000018	0.000018
Vibrio alginolyticus	663	S	12	11	23	1244604	0.000010	0.000018
Enterococcus hirae	1354	S	23	0	23	1244604	0.000018	0.000018
Cutibacterium acnes	1747	S	20	3	23	1244604	0.000016	0.000018
Escherichia virus C40	1914204	S	9	14	23	1244604	0.000007	0.000018
Salmonella phage BPS11Q3	1857099	S	17	6	23	1244604	0.000014	0.000018
Salmonella virus Sasha	2734275	S	19	4	23	1244604	0.000015	0.000018
Klebsiella sp. P1CD1	2267618	S	7	14	21	1244604	0.000006	0.000017
Citrobacter sp. RHB35-C17	2742625	S	7	14	21	1244604	0.000006	0.000017
Enterobacter sp. SES19	2705458	S	18	3	21	1244604	0.000014	0.000017
Leclercia sp. W6	2282310	S	10	11	21	1244604	0.000008	0.000017
Tatumella sp. TA1	2487345	S	21	0	21	1244604	0.000017	0.000017
Serratia nematodiphila	458197	S	4	17	21	1244604	0.000003	0.000017
Dickeya poaceiphila	568768	S	21	0	21	1244604	0.000017	0.000017
Pseudomonas sp. NS1(2017)	2025658	S	21	0	21	1244604	0.000017	0.000017
Pseudomonas sp. S49	1573720	S	13	8	21	1244604	0.000010	0.000017
Shewanella sp. MR-7	60481	S	17	4	21	1244604	0.000014	0.000017
Achromobacter sp. B7	2282475	S	21	0	21	1244604	0.000017	0.000017
Chromobacterium rhizoryzae	1778675	S	10	11	21	1244604	0.000008	0.000017
Lysinibacillus sp. SGAir0095	2070463	S	21	0	21	1244604	0.000017	0.000017
Brevibacterium sp. JNUCC-42	2777985	S	8	13	21	1244604	0.000006	0.000017
Klebsiella phage vB_Kpn_F48	2070028	S	21	0	21	1244604	0.000017	0.000017
Klebsiella sp. BDA134-6	2787706	S	14	6	20	1244604	0.000011	0.000016
Pectobacterium versatile	2488639	S	16	4	20	1244604	0.000013	0.000016
Pseudomonas sp. IzPS59	2774459	S	20	0	20	1244604	0.000016	0.000016
Pseudomonas sp. B10	118613	S	19	1	20	1244604	0.000015	0.000016
Agarilytica rhodophyticola	1737490	S	20	0	20	1244604	0.000016	0.000016
Diaphorobacter sp. HDW4B	2714925	S	20	0	20	1244604	0.000016	0.000016
Burkholderia sp. KJ006	416344	S	3	17	20	1244604	0.000002	0.000016
Bacillus amyloliquefaciens	1390	S	8	12	20	1244604	0.000006	0.000016
Clostridium pasteurianum	1501	S	20	0	20	1244604	0.000016	0.000016
Serratia virus 2050H2	2732710	S	11	9	20	1244604	0.000009	0.000016
Salmonella virus SETP13	2005694	S	15	5	20	1244604	0.000012	0.000016
Enterobacteriaceae endosymbiont of Donacia semicuprea	2675783	S	11	8	19	1244604	0.000009	0.000015
Photorhabdus thracensis	230089	S	14	5	19	1244604	0.000011	0.000015
Serratia ficaria	61651	S	6	13	19	1244604	0.000005	0.000015
Yersinia mollaretii	33060	S	19	0	19	1244604	0.000015	0.000015
Yersinia entomophaga	935293	S	19	0	19	1244604	0.000015	0.000015
Halomonas sp. PGE1	2730360	S	10	9	19	1244604	0.000008	0.000015
Acidovorax sp. JS42	232721	S	7	12	19	1244604	0.000006	0.000015
Paraburkholderia phytofirmans	261302	S	14	5	19	1244604	0.000011	0.000015
Dolichospermum compactum	136073	S	15	4	19	1244604	0.000012	0.000015
Prochlorococcus marinus	1219	S	13	6	19	1244604	0.000010	0.000015
Chryseobacterium indologenes	253	S	18	1	19	1244604	0.000014	0.000015
Escherichia phage FEC14	2053671	S	7	12	19	1244604	0.000006	0.000015
Klebsiella virus PKP126	1981042	S	13	6	19	1244604	0.000010	0.000015
Xenorhabdus poinarii	40577	S	18	0	18	1244604	0.000014	0.000014
Photorhabdus laumondii	2218628	S	15	3	18	1244604	0.000012	0.000014
Arsenophonus endosymbiont of Aphis craccivora	1231049	S	16	1	17	1244604	0.000013	0.000014
Pectobacterium punjabense	2108399	S	18	0	18	1244604	0.000014	0.000014
Edwardsiella hoshinae	93378	S	18	0	18	1244604	0.000014	0.000014
Pseudomonas sp. C27(2019)	2604941	S	17	0	17	1244604	0.000014	0.000014
Pseudomonas sp. IB20	1702250	S	17	0	17	1244604	0.000014	0.000014
Pseudomonas sp. S150	2559074	S	16	2	18	1244604	0.000013	0.000014
Pseudomonas sp. ADPe	2774873	S	16	2	18	1244604	0.000013	0.000014
Pseudomonas sp. Os17	1500686	S	12	6	18	1244604	0.000010	0.000014
Pseudomonas sp. CFSAN084952	2664899	S	10	7	17	1244604	0.000008	0.000014
Pseudomonas sp. A214	1855331	S	7	11	18	1244604	0.000006	0.000014
Pseudomonas xanthomarina	271420	S	18	0	18	1244604	0.000014	0.000014
Pseudomonas lactis	1615674	S	17	1	18	1244604	0.000014	0.000014
Stenotrophomonas sp. SAU14A_NAIMI4_8	2072409	S	10	7	17	1244604	0.000008	0.000014
Xanthomonas citri	346	S	3	14	17	1244604	0.000002	0.000014
Haemophilus influenzae	727	S	15	3	18	1244604	0.000012	0.000014
Thiomicrospira aerophila	92245	S	18	0	18	1244604	0.000014	0.000014
Microbulbifer agarilyticus	260552	S	18	0	18	1244604	0.000014	0.000014
Comamonas serinivorans	1082851	S	17	0	17	1244604	0.000014	0.000014
Variovorax sp. SRS16	282217	S	10	8	18	1244604	0.000008	0.000014
Ottowia sp. 27C	2816950	S	17	0	17	1244604	0.000014	0.000014
Cupriavidus metallidurans	119219	S	15	2	17	1244604	0.000012	0.000014
Achromobacter pestifer	1353889	S	17	0	17	1244604	0.000014	0.000014
Bordetella bronchialis	463025	S	17	0	17	1244604	0.000014	0.000014
Collimonas arenae	279058	S	17	0	17	1244604	0.000014	0.000014
Rhizobium rhizoryzae	451876	S	18	0	18	1244604	0.000014	0.000014
Lysinibacillus timonensis	2086577	S	17	0	17	1244604	0.000014	0.000014
Actinoplanes sp. N902-109	649831	S	16	2	18	1244604	0.000013	0.000014
Blattabacterium cuenoti	1653831	S	17	0	17	1244604	0.000014	0.000014
Erwinia virus Ea35-70	1984778	S	4	14	18	1244604	0.000003	0.000014
Salmonella virus Marshall	1987153	S	2	16	18	1244604	0.000002	0.000014
Escherichia virus VEc3	2053697	S	14	3	17	1244604	0.000011	0.000014
Enterobacter cloacae complex sp. FDA-CDC-AR_0132	2077137	S	5	11	16	1244604	0.000004	0.000013
Enterobacter sp. DSM 30060	2747372	S	7	9	16	1244604	0.000006	0.000013
Xenorhabdus doucetiae	351671	S	16	0	16	1244604	0.000013	0.000013
Yersinia canariae	2607663	S	16	0	16	1244604	0.000013	0.000013
Pectobacterium wasabiae	55208	S	16	0	16	1244604	0.000013	0.000013
Pseudomonas sp. WCS374	1495331	S	2	14	16	1244604	0.000002	0.000013
Acinetobacter sp. 10FS3-1	2563897	S	13	3	16	1244604	0.000010	0.000013
Acidovorax ebreus	721785	S	9	7	16	1244604	0.000007	0.000013
Diaphorobacter polyhydroxybutyrativorans	1546149	S	12	4	16	1244604	0.000010	0.000013
Castellaniella defragrans	75697	S	16	0	16	1244604	0.000013	0.000013
Bradyrhizobium diazoefficiens	1355477	S	12	4	16	1244604	0.000010	0.000013
Microvirga sp. 17 mud 1-3	2082949	S	16	0	16	1244604	0.000013	0.000013
Paenibacillus durus	44251	S	16	0	16	1244604	0.000013	0.000013
Streptomyces sp. S1D4-20	2594462	S	1	15	16	1244604	0.000001	0.000013
Sphingobacterium thalpophilum	259	S	14	2	16	1244604	0.000011	0.000013
Escherichia virus ECML4	1987152	S	5	11	16	1244604	0.000004	0.000013
Escherichia virus Ebrios	2733875	S	16	0	16	1244604	0.000013	0.000013
Yersinia virus YpPY	2733884	S	1	15	16	1244604	0.000001	0.000013
Kluyvera virus Kvp1	1985739	S	10	6	16	1244604	0.000008	0.000013
Klebsiella virus KOX1	2734033	S	10	6	16	1244604	0.000008	0.000013
Citrobacter sp. BDA59-3	2781952	S	15	0	15	1244604	0.000012	0.000012
Enterobacter sp. HK169	1868135	S	10	5	15	1244604	0.000008	0.000012
Phytobacter sp. SCO41	1756993	S	10	5	15	1244604	0.000008	0.000012
Arsenophonus nasoniae	638	S	15	0	15	1244604	0.000012	0.000012
Serratia sp. SSNIH1	1758196	S	2	13	15	1244604	0.000002	0.000012
Jinshanibacter zhutongyuii	2498113	S	15	0	15	1244604	0.000012	0.000012
Pseudomonas sp. MYb193	1827300	S	13	2	15	1244604	0.000010	0.000012
Pseudomonas sp. R4-35-07	658643	S	6	9	15	1244604	0.000005	0.000012
Pseudomonas pelagia	553151	S	15	0	15	1244604	0.000012	0.000012
Catenovulum sediminis	1740262	S	15	0	15	1244604	0.000012	0.000012
Burkholderia pseudomultivorans	1207504	S	12	3	15	1244604	0.000010	0.000012
Achromobacter spanius	217203	S	15	0	15	1244604	0.000012	0.000012
Sterolibacterium denitrificans	157592	S	15	0	15	1244604	0.000012	0.000012
Mesorhizobium sp. 131-2-5	2744519	S	1	14	15	1244604	0.000001	0.000012
Campylobacter insulaenigrae	260714	S	14	1	15	1244604	0.000011	0.000012
Clostridioides difficile	1496	S	15	0	15	1244604	0.000012	0.000012
Mycobacterium kansasii	1768	S	15	0	15	1244604	0.000012	0.000012
Tenacibaculum sp. DSM 106434	2358479	S	15	0	15	1244604	0.000012	0.000012
Enterobacter phage vB_EclM_CIP9	2696340	S	15	0	15	1244604	0.000012	0.000012
Salmonella virus SS3e	2005701	S	7	8	15	1244604	0.000006	0.000012
Escherichia phage E21	2663325	S	14	1	15	1244604	0.000011	0.000012
Salmonella sp. SJTUF14178	2745895	S	1	13	14	1244604	0.000001	0.000011
Phytobacter diazotrophicus	395631	S	9	5	14	1244604	0.000007	0.000011
Yersinia rohdei	29485	S	14	0	14	1244604	0.000011	0.000011
Dickeya sp. NCPPB 3274	568766	S	14	0	14	1244604	0.000011	0.000011
Pseudomonas sp. GR 6-02	1659194	S	9	5	14	1244604	0.000007	0.000011
Pseudomonas sp. NC02	2067572	S	9	5	14	1244604	0.000007	0.000011
Pseudomonas sp. R1-43-08	1173270	S	6	8	14	1244604	0.000005	0.000011
Pseudomonas sp. R2-7-07	658641	S	4	10	14	1244604	0.000003	0.000011
Pseudomonas amygdali	47877	S	10	4	14	1244604	0.000008	0.000011
Pseudomonas xinjiangensis	487184	S	14	0	14	1244604	0.000011	0.000011
Pseudomonas khazarica	2502979	S	13	1	14	1244604	0.000010	0.000011
Pseudomonas glycinae	1785145	S	12	2	14	1244604	0.000010	0.000011
Oceanisphaera avium	1903694	S	14	0	14	1244604	0.000011	0.000011
Photobacterium gaetbulicola	1295392	S	14	0	14	1244604	0.000011	0.000011
Burkholderia sp. LA-2-3-30-S1-D2	1637862	S	12	2	14	1244604	0.000010	0.000011
Cupriavidus oxalaticus	96344	S	14	0	14	1244604	0.000011	0.000011
Cupriavidus necator	106590	S	14	0	14	1244604	0.000011	0.000011
Herbaspirillum seropedicae	964	S	13	1	14	1244604	0.000010	0.000011
Aquabacterium olei	1296669	S	14	0	14	1244604	0.000011	0.000011
Vitreoscilla filiformis	63	S	14	0	14	1244604	0.000011	0.000011
Azospirillum sp. TSH100	652764	S	13	1	14	1244604	0.000010	0.000011
Paenibacillus polymyxa	1406	S	4	10	14	1244604	0.000003	0.000011
Polaribacter sp. L3A8	2686361	S	14	0	14	1244604	0.000011	0.000011
Changchengzhania lutea	2049305	S	14	0	14	1244604	0.000011	0.000011
Escherichia virus RB69	1914161	S	4	10	14	1244604	0.000003	0.000011
Cronobacter virus PBES02	1980960	S	2	12	14	1244604	0.000002	0.000011
Burkholderia phage Mica	2767579	S	14	0	14	1244604	0.000011	0.000011
Erwinia virus RAY	1984779	S	2	12	14	1244604	0.000002	0.000011
Escherichia phage tuntematon	2696455	S	3	11	14	1244604	0.000002	0.000011
Salmonella phage barely	2713278	S	7	7	14	1244604	0.000006	0.000011
Proteus phage Privateer	2712958	S	4	10	14	1244604	0.000003	0.000011
Klebsiella virus KpV522	2734037	S	13	1	14	1244604	0.000010	0.000011
Klebsiella virus Sugarland	2560546	S	10	4	14	1244604	0.000008	0.000011
Enterobacter sp. LU1	1848517	S	5	8	13	1244604	0.000004	0.000010
Enterobacter sp. RHBSTW-00593	2742656	S	3	10	13	1244604	0.000002	0.000010
Leclercia sp. LSNIH1	1920114	S	3	10	13	1244604	0.000002	0.000010
Xenorhabdus hominickii	351679	S	13	0	13	1244604	0.000010	0.000010
Yersinia aleksiciae	263819	S	13	0	13	1244604	0.000010	0.000010
Yersinia aldovae	29483	S	12	0	12	1244604	0.000010	0.000010
Yersinia massiliensis	419257	S	8	4	12	1244604	0.000006	0.000010
Yersinia intermedia	631	S	7	5	12	1244604	0.000006	0.000010
Obesumbacterium proteus	82983	S	10	3	13	1244604	0.000008	0.000010
Pseudomonas sp. DR 5-09	1534110	S	13	0	13	1244604	0.000010	0.000010
Pseudomonas sp. LTJR-52	2479392	S	12	0	12	1244604	0.000010	0.000010
Pseudomonas sp. FDAARGOS_380	2018067	S	12	1	13	1244604	0.000010	0.000010
Pseudomonas sp. CMR12a	658629	S	8	5	13	1244604	0.000006	0.000010
Pseudomonas sp. TKP	1415630	S	8	4	12	1244604	0.000006	0.000010
Pseudomonas sp. KUIN-1	2609418	S	6	6	12	1244604	0.000005	0.000010
Pseudomonas sp. R3-52-08	1173284	S	5	7	12	1244604	0.000004	0.000010
Pseudomonas sp. s211(2017)	2045200	S	5	8	13	1244604	0.000004	0.000010
Pseudomonas gozinkensis	2774461	S	13	0	13	1244604	0.000010	0.000010
Acinetobacter indicus	756892	S	13	0	13	1244604	0.000010	0.000010
Acinetobacter haemolyticus	29430	S	12	0	12	1244604	0.000010	0.000010
Shewanella chilikensis	558541	S	12	1	13	1244604	0.000010	0.000010
Shewanella baltica	62322	S	12	1	13	1244604	0.000010	0.000010
Pseudoalteromonas rubra	43658	S	13	0	13	1244604	0.000010	0.000010
Colwellia sp. Arc7-D	2161872	S	12	0	12	1244604	0.000010	0.000010
Vibrio spartinae	1918945	S	13	0	13	1244604	0.000010	0.000010
Vibrio breoganii	553239	S	13	0	13	1244604	0.000010	0.000010
Xanthomonas campestris	339	S	10	2	12	1244604	0.000008	0.000010
Pasteurella multocida	747	S	11	1	12	1244604	0.000009	0.000010
Methylophaga nitratireducenticrescens	754476	S	13	0	13	1244604	0.000010	0.000010
Hydrogenophaga sp. PBL-H3	434010	S	13	0	13	1244604	0.000010	0.000010
Variovorax sp. WDL1	207745	S	10	2	12	1244604	0.000008	0.000010
Variovorax sp. PBL-H6	434009	S	7	5	12	1244604	0.000006	0.000010
Polaromonas sp. JS666	296591	S	8	4	12	1244604	0.000006	0.000010
Hylemonella gracilis	80880	S	13	0	13	1244604	0.000010	0.000010
Burkholderia stagnalis	1503054	S	12	0	12	1244604	0.000010	0.000010
Burkholderia sp. MS389	2811789	S	11	2	13	1244604	0.000009	0.000010
Burkholderia sp. NRF60-BP8	1637853	S	11	1	12	1244604	0.000009	0.000010
Burkholderia pseudomallei	28450	S	10	3	13	1244604	0.000008	0.000010
Massilia umbonata	864828	S	11	1	12	1244604	0.000009	0.000010
Chromobacterium violaceum	536	S	12	0	12	1244604	0.000010	0.000010
Aquitalea magnusonii	332411	S	11	2	13	1244604	0.000009	0.000010
Rhizobium leguminosarum	384	S	10	3	13	1244604	0.000008	0.000010
Agrobacterium tumefaciens	358	S	7	5	12	1244604	0.000006	0.000010
Bacillus oleronius	38875	S	13	0	13	1244604	0.000010	0.000010
Geobacillus sp. Y4.1MC1	581103	S	2	10	12	1244604	0.000002	0.000010
Solibacillus silvestris	76853	S	13	0	13	1244604	0.000010	0.000010
Staphylococcus lugdunensis	28035	S	12	0	12	1244604	0.000010	0.000010
Vagococcus hydrophili	2714947	S	13	0	13	1244604	0.000010	0.000010
Clostridium sp. MF28	1702238	S	3	10	13	1244604	0.000002	0.000010
Clostridium acetobutylicum	1488	S	13	0	13	1244604	0.000010	0.000010
Clostridium perfringens	1502	S	13	0	13	1244604	0.000010	0.000010
Clostridium carboxidivorans	217159	S	13	0	13	1244604	0.000010	0.000010
Clostridium novyi	1542	S	4	9	13	1244604	0.000003	0.000010
Paeniclostridium sordellii	1505	S	13	0	13	1244604	0.000010	0.000010
Ruminiclostridium herbifermentans	2488810	S	13	0	13	1244604	0.000010	0.000010
Parvimonas micra	33033	S	13	0	13	1244604	0.000010	0.000010
Arthrobacter citreus	1670	S	12	0	12	1244604	0.000010	0.000010
Jiangella sp. DSM 45060	1798224	S	12	0	12	1244604	0.000010	0.000010
Spiroplasma turonicum	216946	S	12	0	12	1244604	0.000010	0.000010
Flavobacterium sp. MDT1-60	1979344	S	13	0	13	1244604	0.000010	0.000010
Flavobacterium psychrophilum	96345	S	12	0	12	1244604	0.000010	0.000010
Empedobacter falsenii	343874	S	12	0	12	1244604	0.000010	0.000010
Sphingobacterium multivorum	28454	S	6	7	13	1244604	0.000005	0.000010
Fusobacterium pseudoperiodonticum	2663009	S	9	4	13	1244604	0.000007	0.000010
Aeromonas phage AS-zj	2024208	S	5	8	13	1244604	0.000004	0.000010
Escherichia phage VEcB	2776821	S	2	11	13	1244604	0.000002	0.000010
Salmonella virus AG11	2005691	S	12	1	13	1244604	0.000010	0.000010
Salmonella virus wksl3	2005702	S	5	7	12	1244604	0.000004	0.000010
Yersinia ruckeri	29486	S	11	0	11	1244604	0.000009	0.000009
Rahnella sp. WMR121	657338	S	11	0	11	1244604	0.000009	0.000009
Pectobacterium odoriferum	78398	S	10	1	11	1244604	0.000008	0.000009
Pseudomonas sp. LBUM920	2126069	S	8	3	11	1244604	0.000006	0.000009
Pseudomonas kribbensis	1628086	S	11	0	11	1244604	0.000009	0.000009
Pseudomonas salegens	1434072	S	11	0	11	1244604	0.000009	0.000009
Pseudomonas sabulinigri	472181	S	11	0	11	1244604	0.000009	0.000009
Parashewanella spongiae	342950	S	11	0	11	1244604	0.000009	0.000009
Vibrio coralliilyticus	190893	S	10	1	11	1244604	0.000008	0.000009
Stenotrophomonas sp. SAU14A_NAIMI4_5	2072413	S	11	0	11	1244604	0.000009	0.000009
Halomonas titanicae	664683	S	3	8	11	1244604	0.000002	0.000009
Francisella sp. FSC1006	1547445	S	10	1	11	1244604	0.000008	0.000009
Pseudohongiella spirulinae	1249552	S	11	0	11	1244604	0.000009	0.000009
Acidovorax sp. RAC01	1842533	S	10	1	11	1244604	0.000008	0.000009
Variovorax sp. HW608	1034889	S	11	0	11	1244604	0.000009	0.000009
Limnohabitans sp. 63ED37-2	1678128	S	11	0	11	1244604	0.000009	0.000009
Burkholderia sp. JP2-270	2217913	S	9	2	11	1244604	0.000007	0.000009
Burkholderia sp. IDO3	1705310	S	6	5	11	1244604	0.000005	0.000009
Rhizobium etli	29449	S	7	4	11	1244604	0.000006	0.000009
Sinorhizobium fredii	380	S	7	4	11	1244604	0.000006	0.000009
Ensifer adhaerens	106592	S	11	0	11	1244604	0.000009	0.000009
Candidatus Deianiraea vastatrix	2163644	S	11	0	11	1244604	0.000009	0.000009
Sorangium cellulosum	56	S	11	0	11	1244604	0.000009	0.000009
Bacillus cytotoxicus	580165	S	11	0	11	1244604	0.000009	0.000009
Peribacillus asahii	228899	S	11	0	11	1244604	0.000009	0.000009
Sporosarcina sp. resist	2762563	S	4	7	11	1244604	0.000003	0.000009
Staphylococcus aureus	1280	S	4	7	11	1244604	0.000003	0.000009
Dolosigranulum pigrum	29394	S	11	0	11	1244604	0.000009	0.000009
Mycolicibacterium psychrotolerans	216929	S	11	0	11	1244604	0.000009	0.000009
Nocardia cyriacigeorgica	135487	S	11	0	11	1244604	0.000009	0.000009
Actinobaculum sp. 313	2495645	S	11	0	11	1244604	0.000009	0.000009
Bifidobacterium adolescentis	1680	S	2	9	11	1244604	0.000002	0.000009
Acholeplasma brassicae	61635	S	11	0	11	1244604	0.000009	0.000009
Flavivirga eckloniae	1803846	S	11	0	11	1244604	0.000009	0.000009
Enterobacteria phage phi92	948870	S	4	7	11	1244604	0.000003	0.000009
Pseudomonas virus Noxifer	2560671	S	11	0	11	1244604	0.000009	0.000009
Enterobacter virus EcpYZU01	2733635	S	11	0	11	1244604	0.000009	0.000009
Citrobacter CrRp3	2733581	S	11	0	11	1244604	0.000009	0.000009
Salmonella virus f18SE	1981032	S	9	2	11	1244604	0.000007	0.000009
Klebsiella phage vB_KpnS_Domnhall	2591369	S	8	3	11	1244604	0.000006	0.000009
Serratia sp. P2ACOL2	2482769	S	4	6	10	1244604	0.000003	0.000008
Pseudomonas sp. R2A2	2213057	S	9	1	10	1244604	0.000007	0.000008
Aeromonas enteropelogenes	29489	S	10	0	10	1244604	0.000008	0.000008
Zobellella denitrificans	347534	S	10	0	10	1244604	0.000008	0.000008
Colwellia psychrerythraea	28229	S	10	0	10	1244604	0.000008	0.000008
Vibrio campbellii	680	S	9	1	10	1244604	0.000007	0.000008
Vibrio atlanticus	693153	S	10	0	10	1244604	0.000008	0.000008
Salinivibrio sp. YCSC6	2003370	S	7	3	10	1244604	0.000006	0.000008
Lysobacter enzymogenes	69	S	9	1	10	1244604	0.000007	0.000008
Thermomonas sp. XSG	2771436	S	10	0	10	1244604	0.000008	0.000008
Kushneria marisflavi	157779	S	10	0	10	1244604	0.000008	0.000008
Histophilus somni	731	S	10	0	10	1244604	0.000008	0.000008
Francisella frigiditurris	1542390	S	10	0	10	1244604	0.000008	0.000008
Legionella hackeliae	449	S	9	1	10	1244604	0.000007	0.000008
Acidovorax cattleyae	80868	S	10	0	10	1244604	0.000008	0.000008
Variovorax sp. RKNM96	2681552	S	10	0	10	1244604	0.000008	0.000008
Burkholderia glumae	337	S	10	0	10	1244604	0.000008	0.000008
Cupriavidus campinensis	151783	S	9	1	10	1244604	0.000007	0.000008
Paraburkholderia fungorum	134537	S	9	1	10	1244604	0.000007	0.000008
Paraburkholderia phenoliruptrix	252970	S	6	4	10	1244604	0.000005	0.000008
Achromobacter sp. AONIH1	1758194	S	10	0	10	1244604	0.000008	0.000008
Janthinobacterium sp. PLB02	2808899	S	9	1	10	1244604	0.000007	0.000008
Janthinobacterium agaricidamnosum	55508	S	8	2	10	1244604	0.000006	0.000008
Candidatus Liberibacter americanus	309868	S	10	0	10	1244604	0.000008	0.000008
Methylobacterium terrae	2202827	S	10	0	10	1244604	0.000008	0.000008
Roseovarius sp. TM1035	391613	S	3	7	10	1244604	0.000002	0.000008
Wolbachia endosymbiont of Trichogramma pretiosum	125593	S	8	2	10	1244604	0.000006	0.000008
Candidatus Nucleicultrix amoebiphila	1509244	S	10	0	10	1244604	0.000008	0.000008
Arcobacter suis	1278212	S	10	0	10	1244604	0.000008	0.000008
Malaciobacter halophilus	197482	S	8	2	10	1244604	0.000006	0.000008
Campylobacter fetus	196	S	8	2	10	1244604	0.000006	0.000008
Sulfurimonas gotlandica	1176482	S	10	0	10	1244604	0.000008	0.000008
Bacillus pseudomycoides	64104	S	10	0	10	1244604	0.000008	0.000008
Bacillus circulans	1397	S	10	0	10	1244604	0.000008	0.000008
Rummeliibacillus stabekisii	241244	S	10	0	10	1244604	0.000008	0.000008
Paenibacillus uliginis	683737	S	10	0	10	1244604	0.000008	0.000008
Listeria welshimeri	1643	S	10	0	10	1244604	0.000008	0.000008
Exiguobacterium antarcticum	132920	S	1	9	10	1244604	0.000001	0.000008
Vagococcus carniphilus	218144	S	10	0	10	1244604	0.000008	0.000008
Tetragenococcus koreensis	290335	S	10	0	10	1244604	0.000008	0.000008
Companilactobacillus crustorum	392416	S	9	1	10	1244604	0.000007	0.000008
Lactiplantibacillus argentoratensis	271881	S	7	3	10	1244604	0.000006	0.000008
Clostridium tetani	1513	S	10	0	10	1244604	0.000008	0.000008
Clostridium scatologenes	1548	S	9	1	10	1244604	0.000007	0.000008
Rhodococcus erythropolis	1833	S	4	6	10	1244604	0.000003	0.000008
Spiroplasma sp. BIUS-1	216964	S	10	0	10	1244604	0.000008	0.000008
Urechidicola croceus	1850246	S	8	2	10	1244604	0.000006	0.000008
Calditerrivibrio nitroreducens	477976	S	10	0	10	1244604	0.000008	0.000008
Thermodesulfobacterium geofontis	1295609	S	10	0	10	1244604	0.000008	0.000008
Salmonella phage Se-B	2700089	S	4	6	10	1244604	0.000003	0.000008
Lelliottia sp. WB101	2153385	S	9	0	9	1244604	0.000007	0.000007
Enterobacteriaceae endosymbiont of Donacia versicolorea	2675788	S	3	6	9	1244604	0.000002	0.000007
Serratia sp. FS14	1327989	S	3	6	9	1244604	0.000002	0.000007
Pragia fontium	82985	S	9	0	9	1244604	0.000007	0.000007
Pseudomonas sp. R3-18-08	1173283	S	6	3	9	1244604	0.000005	0.000007
Pseudomonas sp. DTU12.1	2654238	S	5	4	9	1244604	0.000004	0.000007
Pseudomonas sp. R4-34-07	658642	S	4	5	9	1244604	0.000003	0.000007
Shewanella sp. WE21	2029986	S	9	0	9	1244604	0.000007	0.000007
Shewanella sp. MR-4	60480	S	7	2	9	1244604	0.000006	0.000007
Shewanella donghaensis	238836	S	9	0	9	1244604	0.000007	0.000007
Shewanella livingstonensis	150120	S	9	0	9	1244604	0.000007	0.000007
Pseudoalteromonas issachenkonii	152297	S	2	7	9	1244604	0.000002	0.000007
Vibrio sp. EJY3	1116375	S	5	4	9	1244604	0.000004	0.000007
Vibrio mediterranei	689	S	9	0	9	1244604	0.000007	0.000007
Stenotrophomonas acidaminiphila	128780	S	5	4	9	1244604	0.000004	0.000007
Halomonas sp. THAF5a	2587844	S	9	0	9	1244604	0.000007	0.000007
Thalassolituus oleivorans	187493	S	9	0	9	1244604	0.000007	0.000007
Francisella philomiragia	28110	S	3	6	9	1244604	0.000002	0.000007
Frischella perrara	1267021	S	9	0	9	1244604	0.000007	0.000007
Rhodoferax koreense	1842727	S	9	0	9	1244604	0.000007	0.000007
Pulveribacter suum	2116657	S	9	0	9	1244604	0.000007	0.000007
Bordetella petrii	94624	S	9	0	9	1244604	0.000007	0.000007
Oligella ureolytica	90244	S	9	0	9	1244604	0.000007	0.000007
Herbaspirillum rubrisubalbicans	80842	S	8	1	9	1244604	0.000006	0.000007
Microvirgula aerodenitrificans	57480	S	9	0	9	1244604	0.000007	0.000007
Oryzomicrobium terrae	1735038	S	9	0	9	1244604	0.000007	0.000007
Mesorhizobium sp. M1E.F.Ca.ET.045.02.1.1	2493672	S	8	1	9	1244604	0.000006	0.000007
Mesorhizobium sp. M3A.F.Ca.ET.080.04.2.1	2493676	S	8	1	9	1244604	0.000006	0.000007
Methylorubrum populi	223967	S	6	3	9	1244604	0.000005	0.000007
Azospirillum sp. TSA2s	709810	S	5	4	9	1244604	0.000004	0.000007
Swingsia samuiensis	1293412	S	9	0	9	1244604	0.000007	0.000007
Candidatus Campylobacter infans	2561898	S	9	0	9	1244604	0.000007	0.000007
Campylobacter sputorum	206	S	9	0	9	1244604	0.000007	0.000007
Bacillus sp. FJAT-22090	1581038	S	9	0	9	1244604	0.000007	0.000007
Bacillus sp. Y1	352858	S	9	0	9	1244604	0.000007	0.000007
Bacillus ciccensis	1670641	S	9	0	9	1244604	0.000007	0.000007
Psychrobacillus sp. AK 1817	2303505	S	5	4	9	1244604	0.000004	0.000007
Paenibacillus larvae	1464	S	1	8	9	1244604	0.000001	0.000007
Brevibacillus brevis	1393	S	9	0	9	1244604	0.000007	0.000007
Enterococcus thailandicus	417368	S	9	0	9	1244604	0.000007	0.000007
Streptococcus sp. FDAARGOS_192	1839799	S	4	5	9	1244604	0.000003	0.000007
Clostridium autoethanogenum	84023	S	2	7	9	1244604	0.000002	0.000007
Caloramator sp. E03	2576307	S	9	0	9	1244604	0.000007	0.000007
Thermoanaerobacter siderophilus	106578	S	1	8	9	1244604	0.000001	0.000007
Streptomyces griseus	1911	S	7	2	9	1244604	0.000006	0.000007
Amycolatopsis keratiniphila	129921	S	4	5	9	1244604	0.000003	0.000007
Candidatus Nanopelagicus abundans	1884916	S	9	0	9	1244604	0.000007	0.000007
Nostoc piscinale	224012	S	8	1	9	1244604	0.000006	0.000007
Anabaena cylindrica	1165	S	9	0	9	1244604	0.000007	0.000007
Flammeovirga pectinis	2494373	S	9	0	9	1244604	0.000007	0.000007
Sphingobacterium spiritivorum	258	S	8	1	9	1244604	0.000006	0.000007
Bacteroides fragilis	817	S	3	6	9	1244604	0.000002	0.000007
Nibricoccus aquaticus	2576891	S	9	0	9	1244604	0.000007	0.000007
Leptospira interrogans	173	S	9	0	9	1244604	0.000007	0.000007
Salmonella phage vB_SnwM_CGG4-1	1815631	S	9	0	9	1244604	0.000007	0.000007
Erwinia virus Ea214	1965384	S	9	0	9	1244604	0.000007	0.000007
Salmonella virus STML131	1987154	S	3	6	9	1244604	0.000002	0.000007
Escherichia phage ukendt	2696458	S	1	8	9	1244604	0.000001	0.000007
Enterobacter virus KDA1	2733608	S	9	0	9	1244604	0.000007	0.000007
Salmonella virus SE2	2005699	S	5	4	9	1244604	0.000004	0.000007
Salmonella virus FSLSP030	1173754	S	6	3	9	1244604	0.000005	0.000007
Salmonella phage 1-29	2601628	S	1	8	9	1244604	0.000001	0.000007
Salmonella virus Stitch	1540099	S	4	5	9	1244604	0.000003	0.000007
Salmonella virus S116	2732026	S	2	7	9	1244604	0.000002	0.000007
Klebsiella sp. LTGPAF-6F	1905288	S	1	6	7	1244604	0.000001	0.000006
Enterobacter sp. RFL1396	211595	S	7	0	7	1244604	0.000006	0.000006
Enterobacter sp. E20	1560339	S	5	2	7	1244604	0.000004	0.000006
Enterobacter sp. Crenshaw	1977566	S	1	6	7	1244604	0.000001	0.000006
Raoultella sp. XY-1	2799495	S	2	6	8	1244604	0.000002	0.000006
Metakosakonia sp. MRY16-398	2487150	S	6	1	7	1244604	0.000005	0.000006
Xenorhabdus budapestensis	290110	S	7	0	7	1244604	0.000006	0.000006
Serratia sp. 3ACOL1	2448483	S	5	2	7	1244604	0.000004	0.000006
Yersinia pseudotuberculosis	633	S	8	0	8	1244604	0.000006	0.000006
Dickeya sp. MK7	1224145	S	6	2	8	1244604	0.000005	0.000006
Limnobaculum parvum	2172103	S	8	0	8	1244604	0.000006	0.000006
Pseudomonas sp. GLE121	1329969	S	8	0	8	1244604	0.000006	0.000006
Pseudomonas sp. J380	2605424	S	7	1	8	1244604	0.000006	0.000006
Pseudomonas sp. LH1G9	2083055	S	6	2	8	1244604	0.000005	0.000006
Pseudomonas sp. OST1909	2777367	S	5	2	7	1244604	0.000004	0.000006
Pseudomonas sp. R2-37-08W	1173273	S	4	4	8	1244604	0.000003	0.000006
Pseudomonas sp. R4-39-08	1173288	S	3	4	7	1244604	0.000002	0.000006
Pseudomonas sp. R11-23-07	658632	S	2	5	7	1244604	0.000002	0.000006
Pseudomonas mandelii	75612	S	6	2	8	1244604	0.000005	0.000006
Pseudomonas atacamensis	2565368	S	7	0	7	1244604	0.000006	0.000006
Pseudomonas bijieensis	2681983	S	5	2	7	1244604	0.000004	0.000006
Acinetobacter nosocomialis	106654	S	8	0	8	1244604	0.000006	0.000006
Acinetobacter seifertii	1530123	S	7	0	7	1244604	0.000006	0.000006
Acinetobacter sp. MYb10	1827285	S	8	0	8	1244604	0.000006	0.000006
Acinetobacter sp. YH12138	2601122	S	6	1	7	1244604	0.000005	0.000006
Acinetobacter lanii	2715163	S	8	0	8	1244604	0.000006	0.000006
Acinetobacter wanghuae	2662362	S	8	0	8	1244604	0.000006	0.000006
Shewanella sp. YLB-06	2593655	S	7	0	7	1244604	0.000006	0.000006
Shewanella denitrificans	192073	S	8	0	8	1244604	0.000006	0.000006
Shewanella aestuarii	1028752	S	7	0	7	1244604	0.000006	0.000006
Shewanella xiamenensis	332186	S	6	2	8	1244604	0.000005	0.000006
Marinobacter fonticola	2603215	S	7	0	7	1244604	0.000006	0.000006
Marinobacter salarius	1420917	S	6	1	7	1244604	0.000005	0.000006
Paraglaciecola psychrophila	326544	S	8	0	8	1244604	0.000006	0.000006
Ferrimonas balearica	44012	S	7	0	7	1244604	0.000006	0.000006
Vibrio azureus	512649	S	7	0	7	1244604	0.000006	0.000006
Vibrio sp. HDW18	2714948	S	7	0	7	1244604	0.000006	0.000006
Vibrio sp. THAF190c	2587865	S	7	0	7	1244604	0.000006	0.000006
Vibrio mimicus	674	S	8	0	8	1244604	0.000006	0.000006
Vibrio scophthalmi	45658	S	8	0	8	1244604	0.000006	0.000006
Vibrio furnissii	29494	S	7	0	7	1244604	0.000006	0.000006
Vibrio aquimaris	2587862	S	7	0	7	1244604	0.000006	0.000006
Grimontia hollisae	673	S	8	0	8	1244604	0.000006	0.000006
Xanthomonas oryzae	347	S	8	0	8	1244604	0.000006	0.000006
Xanthomonas hortorum	56454	S	4	3	7	1244604	0.000003	0.000006
Xylella taiwanensis	1444770	S	8	0	8	1244604	0.000006	0.000006
Salinicola tamaricis	1771309	S	8	0	8	1244604	0.000006	0.000006
Marinomonas primoryensis	178399	S	7	0	7	1244604	0.000006	0.000006
Glaesserella parasuis	738	S	8	0	8	1244604	0.000006	0.000006
Francisella sp. Scap27	2589986	S	5	3	8	1244604	0.000004	0.000006
Thiothrix sp.	1032	S	8	0	8	1244604	0.000006	0.000006
Legionella pneumophila	446	S	8	0	8	1244604	0.000006	0.000006
Methylovulum psychrotolerans	1704499	S	7	0	7	1244604	0.000006	0.000006
Gilliamella apicola	1196095	S	7	0	7	1244604	0.000006	0.000006
Comamonas sp. NLF-7-7	2597701	S	8	0	8	1244604	0.000006	0.000006
Acidovorax sp. T1	1858609	S	5	2	7	1244604	0.000004	0.000006
Hydrogenophaga sp. RAC07	1842537	S	8	0	8	1244604	0.000006	0.000006
Hydrogenophaga sp. YM1	2806262	S	7	0	7	1244604	0.000006	0.000006
Hydrogenophaga crassostreae	1763535	S	7	0	7	1244604	0.000006	0.000006
Diaphorobacter aerolatus	1288495	S	8	0	8	1244604	0.000006	0.000006
Burkholderia sp. YI23	1097668	S	3	4	7	1244604	0.000002	0.000006
Burkholderia mallei	13373	S	4	4	8	1244604	0.000003	0.000006
Burkholderia plantarii	41899	S	7	0	7	1244604	0.000006	0.000006
Cupriavidus pauculus	82633	S	7	0	7	1244604	0.000006	0.000006
Paraburkholderia aromaticivorans	2026199	S	6	2	8	1244604	0.000005	0.000006
Pandoraea sputorum	93222	S	8	0	8	1244604	0.000006	0.000006
Pandoraea pnomenusa	93220	S	7	0	7	1244604	0.000006	0.000006
Pandoraea thiooxydans	445709	S	7	0	7	1244604	0.000006	0.000006
Polynucleobacter acidiphobus	556053	S	7	0	7	1244604	0.000006	0.000006
Achromobacter denitrificans	32002	S	7	0	7	1244604	0.000006	0.000006
Massilia sp. YMA4	1593482	S	7	1	8	1244604	0.000006	0.000006
Collimonas fungivorans	158899	S	8	0	8	1244604	0.000006	0.000006
Undibacterium sp. KW1	2058624	S	1	6	7	1244604	0.000001	0.000006
Sphaerotilus natans	34103	S	8	0	8	1244604	0.000006	0.000006
Mitsuaria sp. 7	1658665	S	8	0	8	1244604	0.000006	0.000006
Aquaspirillum sp. LM1	1938604	S	8	0	8	1244604	0.000006	0.000006
Dechloromonas sp. TW-R-39-2	2654218	S	7	0	7	1244604	0.000006	0.000006
Agrobacterium fabacearum	1183401	S	2	6	8	1244604	0.000002	0.000006
Bradyrhizobium erythrophlei	1437360	S	8	0	8	1244604	0.000006	0.000006
Bosea sp. Tri-49	1867715	S	8	0	8	1244604	0.000006	0.000006
Methylobacterium currus	2051553	S	6	1	7	1244604	0.000005	0.000006
Bartonella sp. HY038	2759660	S	6	2	8	1244604	0.000005	0.000006
Bartonella krasnovii	2267275	S	7	0	7	1244604	0.000006	0.000006
Paracoccus sp. Arc7-R13	2500532	S	7	0	7	1244604	0.000006	0.000006
Paracoccus denitrificans	266	S	8	0	8	1244604	0.000006	0.000006
Cognatishimia activa	1715691	S	8	0	8	1244604	0.000006	0.000006
Sphingobium yanoikuyae	13690	S	6	1	7	1244604	0.000005	0.000006
Rhizorhabdus dicambivorans	1850238	S	6	1	7	1244604	0.000005	0.000006
Azospirillum baldaniorum	1064539	S	4	3	7	1244604	0.000003	0.000006
Ehrlichia ruminantium	779	S	7	0	7	1244604	0.000006	0.000006
Aliarcobacter cryaerophilus	28198	S	5	2	7	1244604	0.000004	0.000006
Arcobacter peruensis	2320140	S	5	2	7	1244604	0.000004	0.000006
Campylobacter sp. RM8964	1660074	S	7	1	8	1244604	0.000006	0.000006
Cystobacter fuscus	43	S	8	0	8	1244604	0.000006	0.000006
Desulfobacter postgatei	2293	S	7	0	7	1244604	0.000006	0.000006
Bdellovibrio bacteriovorus	959	S	6	2	8	1244604	0.000005	0.000006
Bacillus mycoides	1405	S	7	1	8	1244604	0.000006	0.000006
Bacillus sp. DSL-17	2567941	S	7	0	7	1244604	0.000006	0.000006
Bacillus pumilus	1408	S	8	0	8	1244604	0.000006	0.000006
Bacillus dafuensis	1742359	S	8	0	8	1244604	0.000006	0.000006
Priestia filamentosa	1402861	S	8	0	8	1244604	0.000006	0.000006
Anoxybacillus flavithermus	33934	S	6	1	7	1244604	0.000005	0.000006
Psychrobacillus glaciei	2283160	S	8	0	8	1244604	0.000006	0.000006
Aeribacillus pallidus	33936	S	7	0	7	1244604	0.000006	0.000006
Sporosarcina ureae	1571	S	7	0	7	1244604	0.000006	0.000006
Paenibacillus sp. FSL H7-0737	1536775	S	7	0	7	1244604	0.000006	0.000006
Paenibacillus sp. JNUCC-32	2777984	S	6	2	8	1244604	0.000005	0.000006
Paenibacillus lycopersici	2704462	S	8	0	8	1244604	0.000006	0.000006
Brevibacillus laterosporus	1465	S	5	2	7	1244604	0.000004	0.000006
Listeria innocua	1642	S	8	0	8	1244604	0.000006	0.000006
Mammaliicoccus sciuri	1296	S	7	0	7	1244604	0.000006	0.000006
Vagococcus teuberi	519472	S	7	0	7	1244604	0.000006	0.000006
Lactobacillus gasseri	1596	S	1	7	8	1244604	0.000001	0.000006
Apilactobacillus kunkeei	148814	S	8	0	8	1244604	0.000006	0.000006
Streptococcus sanguinis	1305	S	8	0	8	1244604	0.000006	0.000006
Streptococcus iniae	1346	S	8	0	8	1244604	0.000006	0.000006
Streptococcus salivarius	1304	S	5	2	7	1244604	0.000004	0.000006
Carnobacterium divergens	2748	S	8	0	8	1244604	0.000006	0.000006
Clostridium sp. DL-VIII	641107	S	8	0	8	1244604	0.000006	0.000006
Clostridium sp. JN-9	2507159	S	7	0	7	1244604	0.000006	0.000006
Clostridium chauvoei	46867	S	8	0	8	1244604	0.000006	0.000006
Clostridium beijerinckii	1520	S	7	1	8	1244604	0.000006	0.000006
Anaerocolumna sedimenticola	2696063	S	7	0	7	1244604	0.000006	0.000006
Lachnoanaerobaculum umeaense	617123	S	8	0	8	1244604	0.000006	0.000006
Thermoanaerobacterium sp. RBIITD	1550240	S	7	0	7	1244604	0.000006	0.000006
Koleobacter methoxysyntrophicus	2751313	S	7	0	7	1244604	0.000006	0.000006
Sporomusa termitida	2377	S	8	0	8	1244604	0.000006	0.000006
Erysipelothrix sp. HDW6B	2714929	S	7	0	7	1244604	0.000006	0.000006
Streptomyces sp. CdTB01	1725411	S	7	0	7	1244604	0.000006	0.000006
Streptacidiphilus bronchialis	2126346	S	7	0	7	1244604	0.000006	0.000006
Mycobacterium cookii	1775	S	7	0	7	1244604	0.000006	0.000006
Brevibacterium casei	33889	S	3	5	8	1244604	0.000002	0.000006
Miniimonas sp. S16	2171623	S	5	2	7	1244604	0.000004	0.000006
Micromonospora aurantiaca	47850	S	3	4	7	1244604	0.000002	0.000006
Saccharopolyspora erythraea	1836	S	5	2	7	1244604	0.000004	0.000006
Thermobifida fusca	2021	S	8	0	8	1244604	0.000006	0.000006
Frankia sp. QA3	710111	S	7	0	7	1244604	0.000006	0.000006
Nostoc sp. NIES-4103	2005458	S	8	0	8	1244604	0.000006	0.000006
Calothrix sp. NIES-2100	1954172	S	5	2	7	1244604	0.000004	0.000006
Spiroplasma diminutum	216936	S	8	0	8	1244604	0.000006	0.000006
Spiroplasma helicoides	216938	S	7	0	7	1244604	0.000006	0.000006
Mycoplasma sp. 1654_15	2725994	S	8	0	8	1244604	0.000006	0.000006
Mycoplasma cloacale	92401	S	7	0	7	1244604	0.000006	0.000006
Acholeplasma palmae	38986	S	7	0	7	1244604	0.000006	0.000006
'Catharanthus roseus' aster yellows phytoplasma	1193712	S	2	6	8	1244604	0.000002	0.000006
Flavobacterium sp. BB8	2816357	S	8	0	8	1244604	0.000006	0.000006
Flavobacterium crocinum	2183896	S	7	1	8	1244604	0.000006	0.000006
Tenacibaculum jejuense	584609	S	8	0	8	1244604	0.000006	0.000006
Capnocytophaga ochracea	1018	S	8	0	8	1244604	0.000006	0.000006
Aquimarina sp. BL5	1714860	S	8	0	8	1244604	0.000006	0.000006
Zunongwangia profunda	398743	S	5	3	8	1244604	0.000004	0.000006
Chryseobacterium sp. StRB126	878220	S	6	1	7	1244604	0.000005	0.000006
Chryseobacterium glaciei	1685010	S	8	0	8	1244604	0.000006	0.000006
Chryseobacterium nakagawai	1241982	S	7	0	7	1244604	0.000006	0.000006
Owenweeksia hongkongensis	253245	S	7	0	7	1244604	0.000006	0.000006
Bernardetia litoralis	999	S	8	0	8	1244604	0.000006	0.000006
Roseivirga pacifica	1267423	S	7	0	7	1244604	0.000006	0.000006
Chlamydia pneumoniae	83558	S	8	0	8	1244604	0.000006	0.000006
Verrucomicrobium sp. GAS474	1882831	S	7	0	7	1244604	0.000006	0.000006
Deferribacter desulfuricans	197162	S	8	0	8	1244604	0.000006	0.000006
Nitrospira japonica	1325564	S	7	0	7	1244604	0.000006	0.000006
Candidatus Babela massiliensis	673862	S	7	0	7	1244604	0.000006	0.000006
Acetomicrobium mobile	97477	S	7	0	7	1244604	0.000006	0.000006
Halorhabdus utahensis	146826	S	7	0	7	1244604	0.000006	0.000006
Methanococcus vannielii	2187	S	8	0	8	1244604	0.000006	0.000006
Methanococcus maripaludis	39152	S	7	0	7	1244604	0.000006	0.000006
Salmonella virus Melville	2560727	S	2	5	7	1244604	0.000002	0.000006
Shigella virus UTAM	1914162	S	2	6	8	1244604	0.000002	0.000006
Pseudomonas phage PPpW-3	1279082	S	7	0	7	1244604	0.000006	0.000006
Erwinia phage vB_EamM_ChrisDB	1883371	S	7	0	7	1244604	0.000006	0.000006
Erwinia phage vB_EamM_Caitlin	1883379	S	7	0	7	1244604	0.000006	0.000006
Salmonella virus Ent1	2005695	S	1	6	7	1244604	0.000001	0.000006
Salmonella phage vB_SenS_ER19	2801563	S	2	5	7	1244604	0.000002	0.000006
Salmonella virus Chi	1541887	S	7	1	8	1244604	0.000006	0.000006
Salmonella phage SS9	2592220	S	4	4	8	1244604	0.000003	0.000006
Salmonella virus Det7	1987157	S	4	3	7	1244604	0.000003	0.000006
Klebsiella phage vB_KpnS_Alina	2591370	S	6	2	8	1244604	0.000005	0.000006
Salmonella phage vB_SenS_SB13	2591135	S	4	3	7	1244604	0.000003	0.000006
Enterobacter sp. ODB01	1827481	S	3	3	6	1244604	0.000002	0.000005
Candidatus Doolittlea endobia	1778262	S	6	0	6	1244604	0.000005	0.000005
Enterobacteriaceae endosymbiont of Macroplea appendiculata	2675790	S	6	0	6	1244604	0.000005	0.000005
Photorhabdus asymbiotica	291112	S	6	0	6	1244604	0.000005	0.000005
Pseudomonas sp. SW-3	147212	S	4	2	6	1244604	0.000003	0.000005
Azotobacter chroococcum	353	S	2	4	6	1244604	0.000002	0.000005
Acinetobacter sp. SWBY1	2079596	S	5	1	6	1244604	0.000004	0.000005
Acinetobacter schindleri	108981	S	6	0	6	1244604	0.000005	0.000005
Acinetobacter piscicola	2006115	S	6	0	6	1244604	0.000005	0.000005
Acinetobacter bereziniae	106648	S	6	0	6	1244604	0.000005	0.000005
Alteromonas mediterranea	314275	S	6	0	6	1244604	0.000005	0.000005
Pseudoalteromonas sp. 13-15	1761891	S	1	5	6	1244604	0.000001	0.000005
Thalassotalea crassostreae	1763536	S	6	0	6	1244604	0.000005	0.000005
Moritella marina	90736	S	6	0	6	1244604	0.000005	0.000005
Photobacterium profundum	74109	S	6	0	6	1244604	0.000005	0.000005
Stenotrophomonas rhizophila	216778	S	6	0	6	1244604	0.000005	0.000005
Lysobacter solisilvae	2763317	S	6	0	6	1244604	0.000005	0.000005
Kushneria konosiri	698828	S	6	0	6	1244604	0.000005	0.000005
Candidatus Portiera aleyrodidarum	91844	S	6	0	6	1244604	0.000005	0.000005
Alcanivorax borkumensis	59754	S	6	0	6	1244604	0.000005	0.000005
Glaesserella sp. 15-184	2030797	S	6	0	6	1244604	0.000005	0.000005
Legionella clemsonensis	1867846	S	6	0	6	1244604	0.000005	0.000005
Methylomonas denitrificans	1538553	S	6	0	6	1244604	0.000005	0.000005
Rhodoferax sediminis	2509614	S	6	0	6	1244604	0.000005	0.000005
Serpentinomonas raichei	1458425	S	6	0	6	1244604	0.000005	0.000005
Ramlibacter tataouinensis	94132	S	6	0	6	1244604	0.000005	0.000005
Simplicispira suum	2109915	S	6	0	6	1244604	0.000005	0.000005
Melaminivora sp. SC2-9	2109913	S	6	0	6	1244604	0.000005	0.000005
Burkholderia sp. KBS0801	1179675	S	3	3	6	1244604	0.000002	0.000005
Cupriavidus pinatubonensis	248026	S	6	0	6	1244604	0.000005	0.000005
Paraburkholderia tropica	92647	S	6	0	6	1244604	0.000005	0.000005
Paraburkholderia xenovorans	36873	S	4	2	6	1244604	0.000003	0.000005
Pandoraea sp. XY-2	2518599	S	6	0	6	1244604	0.000005	0.000005
Achromobacter sp. MFA1 R4	1881016	S	6	0	6	1244604	0.000005	0.000005
Advenella mimigardefordensis	302406	S	6	0	6	1244604	0.000005	0.000005
Herbaspirillum hiltneri	341045	S	6	0	6	1244604	0.000005	0.000005
Herbaspirillum robiniae	2014887	S	6	0	6	1244604	0.000005	0.000005
Rubrivivax gelatinosus	28068	S	6	0	6	1244604	0.000005	0.000005
Chromobacterium sp. Rain0013	2292447	S	6	0	6	1244604	0.000005	0.000005
Iodobacter sp. H11R3	2496266	S	6	0	6	1244604	0.000005	0.000005
Azoarcus communis	41977	S	6	0	6	1244604	0.000005	0.000005
Candidatus Kinetoplastibacterium sorsogonicusi	1576550	S	6	0	6	1244604	0.000005	0.000005
Sinorhizobium americanum	194963	S	6	0	6	1244604	0.000005	0.000005
Bosea sp. AS-1	2015316	S	6	0	6	1244604	0.000005	0.000005
Bosea sp. F3-2	2599640	S	6	0	6	1244604	0.000005	0.000005
Mesorhizobium erdmanii	1777866	S	6	0	6	1244604	0.000005	0.000005
Mesorhizobium ciceri	39645	S	2	4	6	1244604	0.000002	0.000005
Starkeya novella	921	S	2	4	6	1244604	0.000002	0.000005
Phaeobacter gallaeciensis	60890	S	4	2	6	1244604	0.000003	0.000005
Antarctobacter heliothermus	74033	S	6	0	6	1244604	0.000005	0.000005
Roseomonas sp. 546	2768162	S	6	0	6	1244604	0.000005	0.000005
Arcobacter ellisii	913109	S	6	0	6	1244604	0.000005	0.000005
Campylobacter lari	201	S	3	3	6	1244604	0.000002	0.000005
Bacillus horikoshii	79883	S	6	0	6	1244604	0.000005	0.000005
Metabacillus sp. KUDC1714	2745198	S	6	0	6	1244604	0.000005	0.000005
Halobacillus mangrovi	402384	S	6	0	6	1244604	0.000005	0.000005
Parageobacillus thermoglucosidasius	1426	S	1	5	6	1244604	0.000001	0.000005
Planococcus halocryophilus	1215089	S	6	0	6	1244604	0.000005	0.000005
Paenibacillus sp. DCT19	2211212	S	6	0	6	1244604	0.000005	0.000005
Paenibacillus lautus	1401	S	5	1	6	1244604	0.000004	0.000005
Brevibacillus sp. JNUCC-41	2778370	S	5	1	6	1244604	0.000004	0.000005
Listeria seeligeri	1640	S	6	0	6	1244604	0.000005	0.000005
Staphylococcus simulans	1286	S	6	0	6	1244604	0.000005	0.000005
Staphylococcus condimenti	70255	S	6	0	6	1244604	0.000005	0.000005
Lactobacillus amylolyticus	83683	S	6	0	6	1244604	0.000005	0.000005
Companilactobacillus allii	1847728	S	6	0	6	1244604	0.000005	0.000005
Ligilactobacillus animalis	1605	S	6	0	6	1244604	0.000005	0.000005
Leuconostoc mesenteroides	1245	S	6	0	6	1244604	0.000005	0.000005
Streptococcus respiraculi	2021971	S	6	0	6	1244604	0.000005	0.000005
Streptococcus himalayensis	1888195	S	6	0	6	1244604	0.000005	0.000005
Streptococcus lutetiensis	150055	S	2	4	6	1244604	0.000002	0.000005
Carnobacterium maltaromaticum	2751	S	6	0	6	1244604	0.000005	0.000005
Clostridium isatidis	182773	S	6	0	6	1244604	0.000005	0.000005
Lacrimispora saccharolytica	84030	S	6	0	6	1244604	0.000005	0.000005
Candidatus Syntrophocurvum alkaliphilum	2293317	S	6	0	6	1244604	0.000005	0.000005
Halanaerobium praevalens	2331	S	6	0	6	1244604	0.000005	0.000005
Megamonas funiformis	437897	S	6	0	6	1244604	0.000005	0.000005
Streptomyces sp. DSM 40868	2721173	S	6	0	6	1244604	0.000005	0.000005
Streptomyces sp. TLI_053	1855352	S	6	0	6	1244604	0.000005	0.000005
Streptomyces sp. HF10	2692233	S	6	0	6	1244604	0.000005	0.000005
Streptomyces vinaceus	1960	S	6	0	6	1244604	0.000005	0.000005
Mycobacterium paraintracellulare	1138383	S	1	5	6	1244604	0.000001	0.000005
Corynebacterium diphtheriae	1717	S	5	1	6	1244604	0.000004	0.000005
Corynebacterium casei	160386	S	1	5	6	1244604	0.000001	0.000005
Arthrobacter sp. FB24	290399	S	6	0	6	1244604	0.000005	0.000005
Kocuria flava	446860	S	6	0	6	1244604	0.000005	0.000005
Brevibacterium siliguriense	1136497	S	1	5	6	1244604	0.000001	0.000005
Micromonospora echinofusca	47858	S	6	0	6	1244604	0.000005	0.000005
Phytohabitans suffuscus	624315	S	6	0	6	1244604	0.000005	0.000005
Amycolatopsis sp. FDAARGOS 1241	2778070	S	6	0	6	1244604	0.000005	0.000005
Amycolatopsis sp. Hca4	2742131	S	5	1	6	1244604	0.000004	0.000005
Microchaete diplosiphon	1197	S	6	0	6	1244604	0.000005	0.000005
Tolypothrix sp. PCC 7910	2099387	S	6	0	6	1244604	0.000005	0.000005
Chondrocystis sp. NIES-4102	2005460	S	6	0	6	1244604	0.000005	0.000005
Mycoplasma canis	29555	S	5	1	6	1244604	0.000004	0.000005
Deinococcus ficus	317577	S	6	0	6	1244604	0.000005	0.000005
Thermus caldilimi	2483360	S	1	5	6	1244604	0.000001	0.000005
Flavobacterium alkalisoli	2602769	S	6	0	6	1244604	0.000005	0.000005
Polaribacter sp. KT25b	1855336	S	6	0	6	1244604	0.000005	0.000005
Polaribacter sp. ALD11	2058137	S	6	0	6	1244604	0.000005	0.000005
Myroides sp. A21	1583100	S	1	5	6	1244604	0.000001	0.000005
Cellulophaga lytica	979	S	6	0	6	1244604	0.000005	0.000005
Chryseobacterium indoltheticum	254	S	6	0	6	1244604	0.000005	0.000005
Algoriphagus sanaruensis	1727163	S	6	0	6	1244604	0.000005	0.000005
Marivirga tractuosa	1006	S	6	0	6	1244604	0.000005	0.000005
Bremerella volcania	2527984	S	6	0	6	1244604	0.000005	0.000005
Kiritimatiella glycovorans	1307763	S	6	0	6	1244604	0.000005	0.000005
Brachyspira hyodysenteriae	159	S	3	3	6	1244604	0.000002	0.000005
Fusobacterium nucleatum	851	S	5	1	6	1244604	0.000004	0.000005
Hydrogenobacter sp. T-8	1632019	S	6	0	6	1244604	0.000005	0.000005
Thermocrinis minervae	381751	S	6	0	6	1244604	0.000005	0.000005
Haloterrigena turkmenica	62320	S	5	1	6	1244604	0.000004	0.000005
Escherichia phage alia	2696379	S	2	4	6	1244604	0.000002	0.000005
Vibrio virus Aphrodite1	2560831	S	6	0	6	1244604	0.000005	0.000005
Dickeya virus JA11	2734141	S	4	2	6	1244604	0.000003	0.000005
Salmonella phage MA12	1868170	S	3	3	6	1244604	0.000002	0.000005
Salmonella phage vB_SenS_ER3	2801571	S	4	2	6	1244604	0.000003	0.000005
Salmonella phage ST-118	1897740	S	1	5	6	1244604	0.000001	0.000005
Salmonella phage SP1	2025818	S	2	4	6	1244604	0.000002	0.000005
Salmonella virus GG32	2169808	S	2	4	6	1244604	0.000002	0.000005
Anomala cuprea entomopoxvirus	62099	S	6	0	6	1244604	0.000005	0.000005
Enterobacter sp. YSU	648691	S	2	3	5	1244604	0.000002	0.000004
secondary endosymbiont of Ctenarytaina eucalypti	1199245	S	5	0	5	1244604	0.000004	0.000004
Candidatus Riesia pediculischaeffi	428411	S	5	0	5	1244604	0.000004	0.000004
Rahnella aceris	2703885	S	5	0	5	1244604	0.000004	0.000004
Pseudomonas sp. THAF7b	2587845	S	4	1	5	1244604	0.000003	0.000004
Pseudomonas sp. TMW 2.1634	1886807	S	3	2	5	1244604	0.000002	0.000004
Candidatus Pseudomonas adelgestsugas	1302376	S	5	0	5	1244604	0.000004	0.000004
Azotobacter vinelandii	354	S	5	0	5	1244604	0.000004	0.000004
Acinetobacter lwoffii	28090	S	5	0	5	1244604	0.000004	0.000004
Acinetobacter towneri	202956	S	5	0	5	1244604	0.000004	0.000004
Alteromonas macleodii	28108	S	5	0	5	1244604	0.000004	0.000004
Thalassotalea sp. LPB0316	2769490	S	5	0	5	1244604	0.000004	0.000004
Vibrio diabolicus	50719	S	4	1	5	1244604	0.000003	0.000004
Aliivibrio fischeri	668	S	5	0	5	1244604	0.000004	0.000004
Luteimonas sp. YGD11-2	2508168	S	5	0	5	1244604	0.000004	0.000004
Arenimonas daejeonensis	370777	S	5	0	5	1244604	0.000004	0.000004
Dyella sp. G9	2763498	S	5	0	5	1244604	0.000004	0.000004
Ahniella affigens	2021234	S	5	0	5	1244604	0.000004	0.000004
Halomonas sp. MCCC 1A13316	2733487	S	5	0	5	1244604	0.000004	0.000004
Halomonas sp. BC-M4-5	2497861	S	5	0	5	1244604	0.000004	0.000004
Halomonas meridiana	29570	S	5	0	5	1244604	0.000004	0.000004
Oleiphilus messinensis	141451	S	5	0	5	1244604	0.000004	0.000004
Endozoicomonas montiporae	1027273	S	5	0	5	1244604	0.000004	0.000004
Actinobacillus porcitonsillarum	189834	S	5	0	5	1244604	0.000004	0.000004
Thiomicrorhabdus sediminis	2580412	S	5	0	5	1244604	0.000004	0.000004
Sulfurivermis fontis	1972068	S	5	0	5	1244604	0.000004	0.000004
Orbus sp. IPMB12	1635327	S	5	0	5	1244604	0.000004	0.000004
Hydrogenophaga sp. PBC	795665	S	5	0	5	1244604	0.000004	0.000004
Variovorax sp. PBS-H4	434008	S	5	0	5	1244604	0.000004	0.000004
Variovorax boronicumulans	436515	S	4	1	5	1244604	0.000003	0.000004
Rhodoferax sp. PAMC29310	2822760	S	5	0	5	1244604	0.000004	0.000004
Ottowia oryzae	2109914	S	5	0	5	1244604	0.000004	0.000004
Polaromonas naphthalenivorans	216465	S	5	0	5	1244604	0.000004	0.000004
Serpentinomonas mccroryi	1458426	S	5	0	5	1244604	0.000004	0.000004
Kinneretia sp. DAIF2	2714952	S	5	0	5	1244604	0.000004	0.000004
Burkholderia sp. THE68	758782	S	5	0	5	1244604	0.000004	0.000004
Burkholderia oklahomensis	342113	S	5	0	5	1244604	0.000004	0.000004
Burkholderia sp. BDU8	1385592	S	5	0	5	1244604	0.000004	0.000004
Cupriavidus basilensis	68895	S	5	0	5	1244604	0.000004	0.000004
Cupriavidus sp. USMAA2-4	876364	S	2	3	5	1244604	0.000002	0.000004
Paraburkholderia sp. Msb3	2604047	S	4	1	5	1244604	0.000003	0.000004
Paraburkholderia megapolitana	420953	S	5	0	5	1244604	0.000004	0.000004
Paraburkholderia acidiphila	2571747	S	5	0	5	1244604	0.000004	0.000004
Paraburkholderia hospita	169430	S	3	2	5	1244604	0.000002	0.000004
Pandoraea fibrosis	1891094	S	5	0	5	1244604	0.000004	0.000004
Caballeronia sp. SBC1	2705548	S	1	4	5	1244604	0.000001	0.000004
Bordetella flabilis	463014	S	5	0	5	1244604	0.000004	0.000004
Bordetella genomosp. 13	463040	S	5	0	5	1244604	0.000004	0.000004
Bordetella genomosp. 8	1416806	S	5	0	5	1244604	0.000004	0.000004
Bordetella bronchiseptica	518	S	3	2	5	1244604	0.000002	0.000004
Pigmentiphaga sp. H8	2488560	S	5	0	5	1244604	0.000004	0.000004
Herbaspirillum sp. meg3	2025949	S	5	0	5	1244604	0.000004	0.000004
Janthinobacterium lividum	29581	S	5	0	5	1244604	0.000004	0.000004
Methylibium sp. Pch-M	2082386	S	3	2	5	1244604	0.000002	0.000004
Roseateles depolymerans	76731	S	5	0	5	1244604	0.000004	0.000004
Chromobacterium haemolyticum	394935	S	2	3	5	1244604	0.000002	0.000004
Vogesella sp. LIG4	1192162	S	5	0	5	1244604	0.000004	0.000004
Laribacter hongkongensis	168471	S	5	0	5	1244604	0.000004	0.000004
Thauera sp. K11	2005884	S	5	0	5	1244604	0.000004	0.000004
Thauera humireducens	1134435	S	5	0	5	1244604	0.000004	0.000004
Candidatus Kinetoplastibacterium crithidii	33056	S	5	0	5	1244604	0.000004	0.000004
Rhizobium sp. Khangiran2	1435607	S	3	2	5	1244604	0.000002	0.000004
Rhizobium indicum	2583231	S	4	1	5	1244604	0.000003	0.000004
Agrobacterium vitis	373	S	5	0	5	1244604	0.000004	0.000004
Agrobacterium rubi	28099	S	5	0	5	1244604	0.000004	0.000004
Sinorhizobium medicae	110321	S	5	0	5	1244604	0.000004	0.000004
Shinella sp. PSBB067	2715959	S	4	1	5	1244604	0.000003	0.000004
Kaistia sp. 32K	2795690	S	5	0	5	1244604	0.000004	0.000004
Bradyrhizobium sp. ORS 278	114615	S	5	0	5	1244604	0.000004	0.000004
Bradyrhizobium sp. 6(2017)	1197460	S	5	0	5	1244604	0.000004	0.000004
Methylobacterium sp. 4-46	426117	S	5	0	5	1244604	0.000004	0.000004
Methylobacterium sp. 17Sr1-1	2202826	S	4	1	5	1244604	0.000003	0.000004
Methylobacterium mesophilicum	39956	S	5	0	5	1244604	0.000004	0.000004
Pseudolabrys taiwanensis	331696	S	5	0	5	1244604	0.000004	0.000004
Martelella mediterranea	293089	S	5	0	5	1244604	0.000004	0.000004
Mameliella alba	561184	S	5	0	5	1244604	0.000004	0.000004
Sphingomonas sp. AP4-R1	2735134	S	5	0	5	1244604	0.000004	0.000004
Sphingomonas sanxanigenens	397260	S	4	1	5	1244604	0.000003	0.000004
Sphingobium sp. LF-16	2185111	S	3	2	5	1244604	0.000002	0.000004
Sphingopyxis sp. LPB0140	1913578	S	5	0	5	1244604	0.000004	0.000004
Croceicoccus sp. YJ47	2798724	S	5	0	5	1244604	0.000004	0.000004
Azospirillum thermophilum	2202148	S	5	0	5	1244604	0.000004	0.000004
Azospirillum brasilense	192	S	4	1	5	1244604	0.000003	0.000004
Skermanella sp. TT6	2775420	S	5	0	5	1244604	0.000004	0.000004
Ferrovibrio terrae	2594003	S	5	0	5	1244604	0.000004	0.000004
Rickettsiales endosymbiont of Stachyamoeba lipophora	2486578	S	5	0	5	1244604	0.000004	0.000004
Brevundimonas vancanneytii	1325724	S	1	4	5	1244604	0.000001	0.000004
Campylobacter sp. RM6914	1032243	S	5	0	5	1244604	0.000004	0.000004
Helicobacter pylori	210	S	5	0	5	1244604	0.000004	0.000004
Minicystis rosea	888845	S	5	0	5	1244604	0.000004	0.000004
Bacillus luti	2026191	S	5	0	5	1244604	0.000004	0.000004
Bacillus anthracis	1392	S	2	3	5	1244604	0.000002	0.000004
Bacillus sp. HD4P25	2779776	S	5	0	5	1244604	0.000004	0.000004
Bacillus cellulosilyticus	1413	S	5	0	5	1244604	0.000004	0.000004
Peribacillus psychrosaccharolyticus	1407	S	5	0	5	1244604	0.000004	0.000004
Peribacillus butanolivorans	421767	S	4	1	5	1244604	0.000003	0.000004
Virgibacillus sp. Bac330	2419841	S	1	4	5	1244604	0.000001	0.000004
Virgibacillus halodenitrificans	1482	S	5	0	5	1244604	0.000004	0.000004
Alkalihalobacillus miscanthi	2598861	S	5	0	5	1244604	0.000004	0.000004
Neobacillus mesonae	1193713	S	5	0	5	1244604	0.000004	0.000004
Weizmannia coagulans	1398	S	5	0	5	1244604	0.000004	0.000004
Caldibacillus thermoamylovorans	35841	S	5	0	5	1244604	0.000004	0.000004
Paenibacillus sp. Y412MC10	481743	S	4	1	5	1244604	0.000003	0.000004
Paenibacillus sp. lzh-N1	2069255	S	1	4	5	1244604	0.000001	0.000004
Paenibacillus guangzhouensis	1473112	S	5	0	5	1244604	0.000004	0.000004
Staphylococcus xylosus	1288	S	5	0	5	1244604	0.000004	0.000004
Alicyclobacillus sp. TC	2606450	S	5	0	5	1244604	0.000004	0.000004
Fructilactobacillus sanfranciscensis	1625	S	5	0	5	1244604	0.000004	0.000004
Clostridium saccharoperbutylacetonicum	36745	S	5	0	5	1244604	0.000004	0.000004
Clostridium fermenticellae	2068654	S	5	0	5	1244604	0.000004	0.000004
Clostridium thermarum	1716543	S	5	0	5	1244604	0.000004	0.000004
Clostridium taeniosporum	394958	S	5	0	5	1244604	0.000004	0.000004
Clostridium cellulovorans	1493	S	5	0	5	1244604	0.000004	0.000004
Geosporobacter ferrireducens	1424294	S	5	0	5	1244604	0.000004	0.000004
Roseburia intestinalis	166486	S	5	0	5	1244604	0.000004	0.000004
Enterocloster bolteae	208479	S	5	0	5	1244604	0.000004	0.000004
Desulfosporosinus orientis	1563	S	5	0	5	1244604	0.000004	0.000004
Aminipila sp. CBA3637	2697030	S	5	0	5	1244604	0.000004	0.000004
Thermaerobacter sp. FW80	2546351	S	5	0	5	1244604	0.000004	0.000004
Streptomyces sp. XC 2026	2782004	S	5	0	5	1244604	0.000004	0.000004
Streptomyces sp. GS7	2692234	S	5	0	5	1244604	0.000004	0.000004
Streptomyces sp. S8	1837283	S	4	1	5	1244604	0.000003	0.000004
Streptomyces lydicus	47763	S	5	0	5	1244604	0.000004	0.000004
Mycolicibacterium sarraceniae	1534348	S	5	0	5	1244604	0.000004	0.000004
Mycobacteroides abscessus	36809	S	4	1	5	1244604	0.000003	0.000004
Rhodococcus sp. X156	2499145	S	5	0	5	1244604	0.000004	0.000004
Corynebacterium sp. 2039	2675219	S	5	0	5	1244604	0.000004	0.000004
Corynebacterium striatum	43770	S	3	2	5	1244604	0.000002	0.000004
Actinoplanes sp. OR16	946334	S	4	1	5	1244604	0.000003	0.000004
Nocardiopsis gilva	280236	S	5	0	5	1244604	0.000004	0.000004
Rubrobacter sp. SCSIO 52909	2653851	S	5	0	5	1244604	0.000004	0.000004
Synechococcus sp. PCC 7502	1173263	S	5	0	5	1244604	0.000004	0.000004
Gloeothece citriformis	2546356	S	5	0	5	1244604	0.000004	0.000004
Euhalothece natronophila	577489	S	5	0	5	1244604	0.000004	0.000004
Stanieria cyanosphaera	102116	S	5	0	5	1244604	0.000004	0.000004
Spiroplasma sp. TIUS-1	216963	S	5	0	5	1244604	0.000004	0.000004
Spiroplasma eriocheiris	315358	S	5	0	5	1244604	0.000004	0.000004
Mesoplasma coleopterae	324078	S	1	4	5	1244604	0.000001	0.000004
Mycoplasma hominis	2098	S	5	0	5	1244604	0.000004	0.000004
Mycoplasma hyopneumoniae	2099	S	5	0	5	1244604	0.000004	0.000004
Mycoplasma orale	2121	S	5	0	5	1244604	0.000004	0.000004
Flavobacterium sp. CS20	2775246	S	5	0	5	1244604	0.000004	0.000004
Flavobacterium sp. Sr18	935222	S	5	0	5	1244604	0.000004	0.000004
Myroides odoratus	256	S	5	0	5	1244604	0.000004	0.000004
Nonlabens sp. MB-3u-79	2058134	S	5	0	5	1244604	0.000004	0.000004
Chryseobacterium sp. NEB161	2724619	S	3	2	5	1244604	0.000002	0.000004
Empedobacter brevis	247	S	5	0	5	1244604	0.000004	0.000004
Candidatus Amoebophilus asiaticus	281120	S	5	0	5	1244604	0.000004	0.000004
Sphingobacterium sp. B29	1933220	S	2	3	5	1244604	0.000002	0.000004
Parachlamydia acanthamoebae	83552	S	5	0	5	1244604	0.000004	0.000004
Treponema putidum	221027	S	1	4	5	1244604	0.000001	0.000004
Fusobacterium ulcerans	861	S	5	0	5	1244604	0.000004	0.000004
Hydrogenobacter thermophilus	940	S	5	0	5	1244604	0.000004	0.000004
Desulfurobacterium thermolithotrophum	64160	S	5	0	5	1244604	0.000004	0.000004
Thermotomaculum hydrothermale	981385	S	5	0	5	1244604	0.000004	0.000004
Haloplanus rubicundus	1547898	S	5	0	5	1244604	0.000004	0.000004
Halobellus limi	699433	S	3	2	5	1244604	0.000002	0.000004
Methanosarcina mazei	2209	S	5	0	5	1244604	0.000004	0.000004
Methanosarcina sp. MTP4	1434100	S	1	4	5	1244604	0.000001	0.000004
Methanobrevibacter olleyae	294671	S	5	0	5	1244604	0.000004	0.000004
Thermococcus peptonophilus	53952	S	5	0	5	1244604	0.000004	0.000004
Candidatus Nitrosopelagicus brevis	1410606	S	5	0	5	1244604	0.000004	0.000004
Escherichia virus MX01	2560447	S	1	4	5	1244604	0.000001	0.000004
Synechococcus virus AC2014fSyn7803C8	2734085	S	5	0	5	1244604	0.000004	0.000004
Salmonella virus BSP161	2732784	S	1	4	5	1244604	0.000001	0.000004
Escherichia virus AAPEc6	1873778	S	4	1	5	1244604	0.000003	0.000004
Lelliottia virus phD2B	2733580	S	5	0	5	1244604	0.000004	0.000004
Salmonella phage BP12C	1543203	S	4	1	5	1244604	0.000003	0.000004
Salmonella phage bering	2713281	S	3	2	5	1244604	0.000002	0.000004
Salmonella phage SeSz-1	2419752	S	2	3	5	1244604	0.000002	0.000004
Enterobacteriaceae endosymbiont of Donacia provostii	2675781	S	4	0	4	1244604	0.000003	0.000003
Serratia sp. MYb239	2033438	S	1	3	4	1244604	0.000001	0.000003
Yersinia similis	367190	S	4	0	4	1244604	0.000003	0.000003
Rahnella sp. WMR42	657334	S	4	0	4	1244604	0.000003	0.000003
Pseudomonas sp. B14-6	2738843	S	3	1	4	1244604	0.000002	0.000003
Pseudomonas sp. ATCC 43928	676210	S	3	1	4	1244604	0.000002	0.000003
Pseudomonas sp. FDAARGOS_761	2545800	S	1	3	4	1244604	0.000001	0.000003
Acinetobacter calcoaceticus	471	S	4	0	4	1244604	0.000003	0.000003
Acinetobacter johnsonii	40214	S	4	0	4	1244604	0.000003	0.000003
Moraxella osloensis	34062	S	4	0	4	1244604	0.000003	0.000003
Shewanella sp. SNU WT4	2590015	S	4	0	4	1244604	0.000003	0.000003
Shewanella algae	38313	S	4	0	4	1244604	0.000003	0.000003
Shewanella litorisediminis	1173586	S	4	0	4	1244604	0.000003	0.000003
Alteromonas stellipolaris	233316	S	1	3	4	1244604	0.000001	0.000003
Paraglaciecola sp. L3A3	2686358	S	4	0	4	1244604	0.000003	0.000003
Pseudoalteromonas translucida	166935	S	1	3	4	1244604	0.000001	0.000003
Litorilituus sediminis	718192	S	4	0	4	1244604	0.000003	0.000003
Vibrio natriegens	691	S	3	1	4	1244604	0.000002	0.000003
Vibrio metschnikovii	28172	S	4	0	4	1244604	0.000003	0.000003
Xanthomonas albilineans	29447	S	4	0	4	1244604	0.000003	0.000003
Xanthomonas sacchari	56458	S	4	0	4	1244604	0.000003	0.000003
Lysobacter sp. CW239	2762611	S	4	0	4	1244604	0.000003	0.000003
Lysobacter antibioticus	84531	S	4	0	4	1244604	0.000003	0.000003
Thermomonas brevis	215691	S	4	0	4	1244604	0.000003	0.000003
Luteibacter rhizovicinus	242606	S	4	0	4	1244604	0.000003	0.000003
Luteibacter pinisoli	2589080	S	4	0	4	1244604	0.000003	0.000003
Halomonas hydrothermalis	115561	S	4	0	4	1244604	0.000003	0.000003
Halomonas socia	1081866	S	4	0	4	1244604	0.000003	0.000003
Marinomonas arctica	383750	S	4	0	4	1244604	0.000003	0.000003
Ketobacter alkanivorans	1917421	S	4	0	4	1244604	0.000003	0.000003
Saccharospirillum mangrovi	2161747	S	4	0	4	1244604	0.000003	0.000003
Haemophilus parainfluenzae	729	S	4	0	4	1244604	0.000003	0.000003
Bibersteinia trehalosi	47735	S	1	3	4	1244604	0.000001	0.000003
Thiomicrospira cyclica	147268	S	4	0	4	1244604	0.000003	0.000003
Nitrosococcus wardiae	1814290	S	4	0	4	1244604	0.000003	0.000003
Acidihalobacter aeolianus	2792603	S	4	0	4	1244604	0.000003	0.000003
Sulfuriflexus mobilis	1811807	S	4	0	4	1244604	0.000003	0.000003
Methylomonas sp. EFPC1	2812647	S	4	0	4	1244604	0.000003	0.000003
Hydrogenophaga sp. BPS33	2651974	S	4	0	4	1244604	0.000003	0.000003
Variovorax sp. PAMC26660	2762322	S	4	0	4	1244604	0.000003	0.000003
Rhodoferax sp. AJA081-3	2752316	S	4	0	4	1244604	0.000003	0.000003
Ottowia sp. oral taxon 894	1658672	S	4	0	4	1244604	0.000003	0.000003
Verminephrobacter eiseniae	364317	S	4	0	4	1244604	0.000003	0.000003
Burkholderia sp. MS455	2811788	S	3	1	4	1244604	0.000002	0.000003
Burkholderia sp. RPE67	758796	S	2	2	4	1244604	0.000002	0.000003
Paraburkholderia sp. 7MH5	2547399	S	4	0	4	1244604	0.000003	0.000003
Paraburkholderia terricola	169427	S	4	0	4	1244604	0.000003	0.000003
Paraburkholderia phymatum	148447	S	3	1	4	1244604	0.000002	0.000003
Pandoraea pulmonicola	93221	S	4	0	4	1244604	0.000003	0.000003
Ralstonia insidiosa	190721	S	4	0	4	1244604	0.000003	0.000003
Lautropia mirabilis	47671	S	4	0	4	1244604	0.000003	0.000003
Bordetella sp. N	1746199	S	4	0	4	1244604	0.000003	0.000003
Bordetella hinzii	103855	S	4	0	4	1244604	0.000003	0.000003
Pigmentiphaga aceris	1940612	S	4	0	4	1244604	0.000003	0.000003
Orrella dioscoreae	1851544	S	4	0	4	1244604	0.000003	0.000003
Massilia oculi	945844	S	4	0	4	1244604	0.000003	0.000003
Herbaspirillum huttiense	863372	S	4	0	4	1244604	0.000003	0.000003
Janthinobacterium sp. B9-8	1236179	S	4	0	4	1244604	0.000003	0.000003
Janthinobacterium tructae	2590869	S	4	0	4	1244604	0.000003	0.000003
Rhizobacter sp. AJA081-3	2753607	S	4	0	4	1244604	0.000003	0.000003
Thiomonas sp. X19	1050370	S	2	2	4	1244604	0.000002	0.000003
Leptothrix cholodnii	34029	S	4	0	4	1244604	0.000003	0.000003
Xylophilus rhododendri	2697032	S	4	0	4	1244604	0.000003	0.000003
Chromobacterium sp. ATCC 53434	2059672	S	4	0	4	1244604	0.000003	0.000003
Chromobacterium vaccinii	1108595	S	4	0	4	1244604	0.000003	0.000003
Iodobacter fluviatilis	537	S	4	0	4	1244604	0.000003	0.000003
Jeongeupia sp. USM3	1906741	S	3	1	4	1244604	0.000002	0.000003
Pseudogulbenkiania sp. NH8B	748280	S	4	0	4	1244604	0.000003	0.000003
Thauera sp. MZ1T	85643	S	4	0	4	1244604	0.000003	0.000003
Thauera hydrothermalis	2184083	S	4	0	4	1244604	0.000003	0.000003
Azospira restricta	404405	S	4	0	4	1244604	0.000003	0.000003
Azospira sp. I09	1765049	S	1	3	4	1244604	0.000001	0.000003
Aromatoleum aromaticum	551760	S	4	0	4	1244604	0.000003	0.000003
Niveibacterium sp. HC41	2811415	S	4	0	4	1244604	0.000003	0.000003
Denitratisoma sp. DHT3	1981880	S	4	0	4	1244604	0.000003	0.000003
Nitrosospira briensis	35799	S	4	0	4	1244604	0.000003	0.000003
Sideroxydans lithotrophicus	63745	S	4	0	4	1244604	0.000003	0.000003
Candidatus Accumulibacter phosphatis	327160	S	4	0	4	1244604	0.000003	0.000003
Neorhizobium galegae	399	S	4	0	4	1244604	0.000003	0.000003
Sinorhizobium sp. M14	430451	S	1	3	4	1244604	0.000001	0.000003
Ensifer mexicanus	375549	S	4	0	4	1244604	0.000003	0.000003
Ensifer alkalisoli	1752398	S	4	0	4	1244604	0.000003	0.000003
Bradyrhizobium sp. BTAi1	288000	S	4	0	4	1244604	0.000003	0.000003
Bradyrhizobium sp. SK17	2057741	S	4	0	4	1244604	0.000003	0.000003
Bradyrhizobium paxllaeri	190148	S	4	0	4	1244604	0.000003	0.000003
Mesorhizobium sp. 8	2584466	S	4	0	4	1244604	0.000003	0.000003
Mesorhizobium sp. M4B.F.Ca.ET.058.02.1.1	2493675	S	4	0	4	1244604	0.000003	0.000003
Methylobacterium indicum	1775910	S	4	0	4	1244604	0.000003	0.000003
Methylobacterium radiotolerans	31998	S	1	3	4	1244604	0.000001	0.000003
Bartonella apis	1686310	S	4	0	4	1244604	0.000003	0.000003
Bartonella australis	388640	S	4	0	4	1244604	0.000003	0.000003
Rhodoplanes sp. Z2-YC6860	674703	S	4	0	4	1244604	0.000003	0.000003
Paracoccus aminovorans	34004	S	4	0	4	1244604	0.000003	0.000003
Sulfitobacter sp. AM1-D1	1917485	S	2	2	4	1244604	0.000002	0.000003
Ruegeria pomeroyi	89184	S	4	0	4	1244604	0.000003	0.000003
Gemmobacter sp. HYN0069	2169400	S	4	0	4	1244604	0.000003	0.000003
Sphingomonas sp. AAP5	1523415	S	4	0	4	1244604	0.000003	0.000003
Sphingobium japonicum	332056	S	4	0	4	1244604	0.000003	0.000003
Novosphingobium sp. P6W	1609758	S	4	0	4	1244604	0.000003	0.000003
Sandaracinobacter sp. M6	2759707	S	4	0	4	1244604	0.000003	0.000003
Azospirillum lipoferum	193	S	4	0	4	1244604	0.000003	0.000003
Azospirillum ramasamyi	682998	S	4	0	4	1244604	0.000003	0.000003
Tistrella mobilis	171437	S	4	0	4	1244604	0.000003	0.000003
Nitrospirillum amazonense	28077	S	4	0	4	1244604	0.000003	0.000003
Acetobacter ascendens	481146	S	4	0	4	1244604	0.000003	0.000003
Komagataeibacter xylinus	28448	S	3	1	4	1244604	0.000002	0.000003
Acidiphilium cryptum	524	S	4	0	4	1244604	0.000003	0.000003
Wolbachia endosymbiont of Cruorifilaria tuberocauda	1812111	S	4	0	4	1244604	0.000003	0.000003
Wolbachia pipientis	955	S	2	2	4	1244604	0.000002	0.000003
Ehrlichia sp. HF	391036	S	4	0	4	1244604	0.000003	0.000003
Candidatus Midichloria mitochondrii	234827	S	4	0	4	1244604	0.000003	0.000003
Hyphomonas sp. CACIAM 19H1	1873716	S	4	0	4	1244604	0.000003	0.000003
Aliarcobacter butzleri	28197	S	4	0	4	1244604	0.000003	0.000003
Aliarcobacter faecis	1564138	S	3	1	4	1244604	0.000002	0.000003
Halarcobacter ebronensis	1462615	S	4	0	4	1244604	0.000003	0.000003
Campylobacter ureolyticus	827	S	4	0	4	1244604	0.000003	0.000003
Campylobacter blaseri	2042961	S	4	0	4	1244604	0.000003	0.000003
Sulfurimonas paralvinellae	317658	S	4	0	4	1244604	0.000003	0.000003
Myxococcus xanthus	34	S	2	2	4	1244604	0.000002	0.000003
Desulfosarcina ovata	83564	S	4	0	4	1244604	0.000003	0.000003
Desulfopila sp. IMCC35005	2569541	S	4	0	4	1244604	0.000003	0.000003
Desulfovibrio marinus	370038	S	4	0	4	1244604	0.000003	0.000003
Bacillus sp. 1NLA3E	666686	S	4	0	4	1244604	0.000003	0.000003
Bacillus sp. JS	1127744	S	1	3	4	1244604	0.000001	0.000003
Bacillus weihaiensis	1547283	S	4	0	4	1244604	0.000003	0.000003
Alkalihalobacillus pseudofirmus	79885	S	4	0	4	1244604	0.000003	0.000003
Metabacillus sp. cB07	2806989	S	4	0	4	1244604	0.000003	0.000003
Pradoshia sp. D12	2651284	S	4	0	4	1244604	0.000003	0.000003
Sporosarcina sp. PTS2304	2283194	S	4	0	4	1244604	0.000003	0.000003
Sporosarcina sp. Te-1	2818390	S	4	0	4	1244604	0.000003	0.000003
Paenisporosarcina antarctica	417367	S	4	0	4	1244604	0.000003	0.000003
Paenibacillus sp. IHB B 3084	867076	S	4	0	4	1244604	0.000003	0.000003
Paenibacillus sp. JNUCC-31	2777983	S	4	0	4	1244604	0.000003	0.000003
Paenibacillus sp. E222	2748863	S	4	0	4	1244604	0.000003	0.000003
Paenibacillus sp. B01	2660554	S	4	0	4	1244604	0.000003	0.000003
Paenibacillus sp. FSL H7-0357	1536774	S	4	0	4	1244604	0.000003	0.000003
Paenibacillus sp. IHBB 10380	1566358	S	4	0	4	1244604	0.000003	0.000003
Paenibacillus lutimineralis	2707005	S	4	0	4	1244604	0.000003	0.000003
Paenibacillus glucanolyticus	59843	S	2	2	4	1244604	0.000002	0.000003
Listeria grayi	1641	S	4	0	4	1244604	0.000003	0.000003
Staphylococcus pseudintermedius	283734	S	4	0	4	1244604	0.000003	0.000003
Staphylococcus saccharolyticus	33028	S	4	0	4	1244604	0.000003	0.000003
Staphylococcus sp. M0911	2025492	S	2	2	4	1244604	0.000002	0.000003
Macrococcus caseolyticus	69966	S	4	0	4	1244604	0.000003	0.000003
Gemella haemolysans	1379	S	4	0	4	1244604	0.000003	0.000003
Tumebacillus avium	1903704	S	4	0	4	1244604	0.000003	0.000003
Enterococcus avium	33945	S	4	0	4	1244604	0.000003	0.000003
Vagococcus zengguangii	2571750	S	4	0	4	1244604	0.000003	0.000003
Weissella confusa	1583	S	4	0	4	1244604	0.000003	0.000003
Streptococcus gallolyticus	315405	S	3	1	4	1244604	0.000002	0.000003
Carnobacterium inhibens	147709	S	4	0	4	1244604	0.000003	0.000003
Jeotgalibaca ciconiae	2496265	S	3	1	4	1244604	0.000002	0.000003
Marinilactibacillus sp. 15R	1911586	S	4	0	4	1244604	0.000003	0.000003
Clostridium sp. AWRP	2212991	S	4	0	4	1244604	0.000003	0.000003
Clostridium baratii	1561	S	4	0	4	1244604	0.000003	0.000003
Clostridium butyricum	1492	S	4	0	4	1244604	0.000003	0.000003
Clostridium ljungdahlii	1538	S	1	3	4	1244604	0.000001	0.000003
Acetoanaerobium sticklandii	1511	S	4	0	4	1244604	0.000003	0.000003
[Ruminococcus] gnavus	33038	S	4	0	4	1244604	0.000003	0.000003
Blautia producta	33035	S	2	2	4	1244604	0.000002	0.000003
Anaerostipes caccae	105841	S	4	0	4	1244604	0.000003	0.000003
Ruminococcus albus	1264	S	4	0	4	1244604	0.000003	0.000003
Ruminococcus sp. JE7A12	2564099	S	4	0	4	1244604	0.000003	0.000003
Desulfitobacterium dichloroeliminans	233055	S	4	0	4	1244604	0.000003	0.000003
Desulfofarcimen acetoxidans	58138	S	4	0	4	1244604	0.000003	0.000003
Eubacterium limosum	1736	S	3	1	4	1244604	0.000002	0.000003
Tissierellia sp. JN-28	2507161	S	4	0	4	1244604	0.000003	0.000003
Streptomyces albus	1888	S	4	0	4	1244604	0.000003	0.000003
Streptomyces cadmiisoli	2184053	S	4	0	4	1244604	0.000003	0.000003
Streptomyces nigra	1827580	S	4	0	4	1244604	0.000003	0.000003
Streptomyces tsukubensis	83656	S	4	0	4	1244604	0.000003	0.000003
Streptomyces seoulensis	73044	S	4	0	4	1244604	0.000003	0.000003
Streptomyces albulus	68570	S	4	0	4	1244604	0.000003	0.000003
Streptomyces glomeroaurantiacus	68210	S	4	0	4	1244604	0.000003	0.000003
Streptomyces luteoverticillatus	66425	S	4	0	4	1244604	0.000003	0.000003
Streptomyces avermitilis	33903	S	4	0	4	1244604	0.000003	0.000003
Streptomyces cattleya	29303	S	4	0	4	1244604	0.000003	0.000003
Mycobacterium paragordonae	1389713	S	4	0	4	1244604	0.000003	0.000003
Mycolicibacterium goodii	134601	S	4	0	4	1244604	0.000003	0.000003
Mycolicibacterium madagascariense	212765	S	4	0	4	1244604	0.000003	0.000003
Mycolicibacterium alvei	67081	S	4	0	4	1244604	0.000003	0.000003
Rhodococcus sp. SGAir0479	2567884	S	4	0	4	1244604	0.000003	0.000003
Nocardia brasiliensis	37326	S	4	0	4	1244604	0.000003	0.000003
Nocardia terpenica	455432	S	4	0	4	1244604	0.000003	0.000003
Tomitella sp. HY188	2597660	S	3	1	4	1244604	0.000002	0.000003
Microbacterium sp. 1S1	2606451	S	2	2	4	1244604	0.000002	0.000003
Agrococcus sp. SGAir0287	2070347	S	4	0	4	1244604	0.000003	0.000003
Microterricola viridarii	412690	S	4	0	4	1244604	0.000003	0.000003
Cellulomonas taurus	2729175	S	4	0	4	1244604	0.000003	0.000003
Serinicoccus hydrothermalis	1758689	S	4	0	4	1244604	0.000003	0.000003
Tetrasphaera sp. HKS02	1813880	S	4	0	4	1244604	0.000003	0.000003
Georgenia sp. Z443	2589797	S	4	0	4	1244604	0.000003	0.000003
Micromonospora inositola	47865	S	4	0	4	1244604	0.000003	0.000003
Plantactinospora sp. BB1	2071627	S	2	2	4	1244604	0.000002	0.000003
Nocardioides sp. S-713	2760089	S	4	0	4	1244604	0.000003	0.000003
Nocardioides sp. S5	2017486	S	3	1	4	1244604	0.000002	0.000003
Microlunatus soli	630515	S	4	0	4	1244604	0.000003	0.000003
Kribbella qitaiheensis	1544730	S	4	0	4	1244604	0.000003	0.000003
Amycolatopsis mediterranei	33910	S	4	0	4	1244604	0.000003	0.000003
Pseudonocardia broussonetiae	2736640	S	4	0	4	1244604	0.000003	0.000003
Pseudonocardia autotrophica	2074	S	3	1	4	1244604	0.000002	0.000003
Nocardiopsis dassonvillei	2014	S	4	0	4	1244604	0.000003	0.000003
Trueperella pyogenes	1661	S	3	1	4	1244604	0.000002	0.000003
Gardnerella leopoldii	2792978	S	4	0	4	1244604	0.000003	0.000003
Nakamurella multipartita	53461	S	4	0	4	1244604	0.000003	0.000003
Jatrophihabitans sp. GAS493	1907575	S	4	0	4	1244604	0.000003	0.000003
Stackebrandtia nassauensis	283811	S	4	0	4	1244604	0.000003	0.000003
Nostoc sp. 'Lobaria pulmonaria (5183) cyanobiont'	1618022	S	4	0	4	1244604	0.000003	0.000003
Nostoc linckia	92942	S	4	0	4	1244604	0.000003	0.000003
Synechococcus sp. BMK-MC-1	1442551	S	4	0	4	1244604	0.000003	0.000003
Moorea producens	1155739	S	4	0	4	1244604	0.000003	0.000003
Mesoplasma syrphidae	225999	S	4	0	4	1244604	0.000003	0.000003
Deinococcus gobiensis	502394	S	4	0	4	1244604	0.000003	0.000003
Flavobacterium sp. CJ74	2294119	S	4	0	4	1244604	0.000003	0.000003
Flavobacterium branchiophilum	55197	S	4	0	4	1244604	0.000003	0.000003
Tenacibaculum maritimum	107401	S	4	0	4	1244604	0.000003	0.000003
Capnocytophaga endodontalis	2708117	S	4	0	4	1244604	0.000003	0.000003
Formosa sp. Hel1_33_131	1336794	S	4	0	4	1244604	0.000003	0.000003
Formosa sp. Hel1_31_208	1798225	S	4	0	4	1244604	0.000003	0.000003
Algibacter sp. L3A6	2686366	S	4	0	4	1244604	0.000003	0.000003
Seonamhaeicola sp. S2-3	1936081	S	4	0	4	1244604	0.000003	0.000003
Chryseobacterium cucumeris	1813611	S	4	0	4	1244604	0.000003	0.000003
Chryseobacterium shandongense	1493872	S	4	0	4	1244604	0.000003	0.000003
Chryseobacterium gallinarum	1324352	S	4	0	4	1244604	0.000003	0.000003
Chryseobacterium lactis	1241981	S	4	0	4	1244604	0.000003	0.000003
Kaistella carnis	1241979	S	4	0	4	1244604	0.000003	0.000003
Fluviicola taffensis	191579	S	4	0	4	1244604	0.000003	0.000003
Hymenobacter sp. BRD67	2675877	S	4	0	4	1244604	0.000003	0.000003
Hymenobacter jejuensis	2502781	S	4	0	4	1244604	0.000003	0.000003
Adhaeribacter swui	2086471	S	4	0	4	1244604	0.000003	0.000003
Mucilaginibacter sp. F39-2	2728022	S	4	0	4	1244604	0.000003	0.000003
Mucilaginibacter xinganensis	1234841	S	4	0	4	1244604	0.000003	0.000003
Prevotella ruminicola	839	S	4	0	4	1244604	0.000003	0.000003
Alistipes shahii	328814	S	2	2	4	1244604	0.000002	0.000003
Tannerella sp. oral taxon HOT-286	712710	S	4	0	4	1244604	0.000003	0.000003
Chitinophaga sp. MD30	2033437	S	3	1	4	1244604	0.000002	0.000003
Flavisolibacter ginsenosidimutans	661481	S	4	0	4	1244604	0.000003	0.000003
Arachidicoccus soli	2341117	S	4	0	4	1244604	0.000003	0.000003
Rubinisphaera brasiliensis	119	S	4	0	4	1244604	0.000003	0.000003
Gemmata obscuriglobus	114	S	4	0	4	1244604	0.000003	0.000003
Treponema phagedenis	162	S	2	2	4	1244604	0.000002	0.000003
Brachyspira intermedia	84377	S	4	0	4	1244604	0.000003	0.000003
Granulicella sp. WH15	2602070	S	4	0	4	1244604	0.000003	0.000003
Candidatus Nitrospira inopinata	1715989	S	4	0	4	1244604	0.000003	0.000003
Methanolobus zinderi	536044	S	4	0	4	1244604	0.000003	0.000003
Acidianus sulfidivorans	312539	S	4	0	4	1244604	0.000003	0.000003
Thermoplasma volcanium	50339	S	4	0	4	1244604	0.000003	0.000003
Escherichia virus JS98	2004457	S	1	3	4	1244604	0.000001	0.000003
Vibrio virus nt1	1914020	S	4	0	4	1244604	0.000003	0.000003
Ralstonia phage phiRSP	2201420	S	4	0	4	1244604	0.000003	0.000003
Pantoea phage vB_PagM_AAM37	2588093	S	4	0	4	1244604	0.000003	0.000003
Escherichia phage nepoznato	2696431	S	1	3	4	1244604	0.000001	0.000003
Erwinia virus Yoloswag	2734158	S	4	0	4	1244604	0.000003	0.000003
Pectobacterium virus DUPPII	2733887	S	4	0	4	1244604	0.000003	0.000003
Proteus virus PM75	2733610	S	4	0	4	1244604	0.000003	0.000003
Pectobacterium virus PP99	2733917	S	4	0	4	1244604	0.000003	0.000003
Caulobacter virus Percy	2733946	S	4	0	4	1244604	0.000003	0.000003
Votkovvirus S28C10	2733968	S	4	0	4	1244604	0.000003	0.000003
Enterobacteria phage mEp460	1147152	S	2	2	4	1244604	0.000002	0.000003
Salmonella phage 37	1654890	S	3	1	4	1244604	0.000002	0.000003
Salmonella phage vB_SenS_BPS1	2801546	S	1	3	4	1244604	0.000001	0.000003
Escherichia virus HK106	2169920	S	2	2	4	1244604	0.000002	0.000003
Salmonella virus PM10	2169809	S	2	2	4	1244604	0.000002	0.000003
Salmonella virus S124	2732027	S	4	0	4	1244604	0.000003	0.000003
Aeromonas virus AhSzw1	2733999	S	4	0	4	1244604	0.000003	0.000003
Bluetongue virus	40051	S	4	0	4	1244604	0.000003	0.000003
Glossina hytrosavirus	2747309	S	4	0	4	1244604	0.000003	0.000003
Klebsiella sp. KCL-2	160057	S	2	0	2	1244604	0.000002	0.000002
Klebsiella sp. MPUS7	2697371	S	1	2	3	1244604	0.000001	0.000002
Citrobacter sp. 36-4CPA	1036018	S	2	0	2	1244604	0.000002	0.000002
Salmonella sp. SSDFZ69	2500543	S	2	0	2	1244604	0.000002	0.000002
Shigella sp. MO17	1072658	S	1	1	2	1244604	0.000001	0.000002
Blochmannia endosymbiont of Camponotus nipponensis	2681986	S	2	1	3	1244604	0.000002	0.000002
Candidatus Hoaglandella endobia	1778263	S	3	0	3	1244604	0.000002	0.000002
Enterobacteriaceae endosymbiont of Plateumaris pusilla	2675795	S	2	0	2	1244604	0.000002	0.000002
Enterobacteriaceae endosymbiont of Macroplea mutica	2675791	S	2	0	2	1244604	0.000002	0.000002
Candidatus Moranella endobia	1048758	S	3	0	3	1244604	0.000002	0.000002
Candidatus Pantoea carbekii	1235990	S	2	0	2	1244604	0.000002	0.000002
Erwinia piriflorinigrans	665097	S	2	0	2	1244604	0.000002	0.000002
Yersinia hibernica	2339259	S	2	0	2	1244604	0.000002	0.000002
Yersinia sp. KBS0713	1179669	S	2	1	3	1244604	0.000002	0.000002
Rahnella sp. Y9602	741091	S	2	1	3	1244604	0.000002	0.000002
Candidatus Fukatsuia symbiotica	1878942	S	3	0	3	1244604	0.000002	0.000002
Dickeya sp. Secpp 1600	2037915	S	2	0	2	1244604	0.000002	0.000002
Edwardsiella sp. EA181011	1578828	S	2	0	2	1244604	0.000002	0.000002
Pseudomonas sp. MPDS	2762896	S	1	1	2	1244604	0.000001	0.000002
Pseudomonas sp. Lz4W	1206777	S	3	0	3	1244604	0.000002	0.000002
Pseudomonas avellanae	46257	S	1	2	3	1244604	0.000001	0.000002
Pseudomonas cerasi	1583341	S	3	0	3	1244604	0.000002	0.000002
Oblitimonas alkaliphila	1697053	S	3	0	3	1244604	0.000002	0.000002
Entomomonas moraniae	2213226	S	2	0	2	1244604	0.000002	0.000002
Permianibacter aggregans	1510150	S	2	0	2	1244604	0.000002	0.000002
Acinetobacter lactucae	1785128	S	3	0	3	1244604	0.000002	0.000002
Acinetobacter sp. CS-2	2798861	S	3	0	3	1244604	0.000002	0.000002
Acinetobacter sp. TGL-Y2	1407071	S	3	0	3	1244604	0.000002	0.000002
Acinetobacter sp. TTH0-4	1646498	S	2	0	2	1244604	0.000002	0.000002
Acinetobacter ursingii	108980	S	3	0	3	1244604	0.000002	0.000002
Acinetobacter baylyi	202950	S	3	0	3	1244604	0.000002	0.000002
Acinetobacter radioresistens	40216	S	3	0	3	1244604	0.000002	0.000002
Acinetobacter equi	1324350	S	3	0	3	1244604	0.000002	0.000002
Psychrobacter sp. P11G3	1699623	S	3	0	3	1244604	0.000002	0.000002
Psychrobacter sp.	56811	S	2	0	2	1244604	0.000002	0.000002
Psychrobacter sp. YP14	2203895	S	2	1	3	1244604	0.000002	0.000002
Oceanimonas sp. GK1	511062	S	3	0	3	1244604	0.000002	0.000002
Shewanella sp. Scap07	2589987	S	3	0	3	1244604	0.000002	0.000002
Shewanella sp. Arc9-LZ	2698686	S	3	0	3	1244604	0.000002	0.000002
Shewanella sp. FJAT-51800	2814294	S	2	0	2	1244604	0.000002	0.000002
Shewanella sp. W3-18-1	351745	S	1	2	3	1244604	0.000001	0.000002
Shewanella sediminis	271097	S	2	0	2	1244604	0.000002	0.000002
Shewanella halifaxensis	271098	S	2	0	2	1244604	0.000002	0.000002
Shewanella piezotolerans	404011	S	2	0	2	1244604	0.000002	0.000002
Shewanella maritima	2520507	S	2	0	2	1244604	0.000002	0.000002
Marinobacter sp. JH2	2547598	S	3	0	3	1244604	0.000002	0.000002
Marinobacter sp. LQ44	1749259	S	2	0	2	1244604	0.000002	0.000002
Marinobacter sp. CP1	1671721	S	1	1	2	1244604	0.000001	0.000002
Marinobacter hydrocarbonoclasticus	2743	S	3	0	3	1244604	0.000002	0.000002
Alteromonas sp. RKMC-009	2267264	S	2	0	2	1244604	0.000002	0.000002
Alteromonas sp. B31-7	2785913	S	1	2	3	1244604	0.000001	0.000002
Paraglaciecola mesophila	197222	S	2	0	2	1244604	0.000002	0.000002
Salinimonas lutimaris	914153	S	3	0	3	1244604	0.000002	0.000002
Salinimonas sp. G2-b	2785918	S	2	0	2	1244604	0.000002	0.000002
Salinimonas sediminis	2303538	S	2	0	2	1244604	0.000002	0.000002
Agarivorans gilvus	680279	S	3	0	3	1244604	0.000002	0.000002
Hydrocarboniclastica marina	2259620	S	3	0	3	1244604	0.000002	0.000002
Saliniradius amylolyticus	2183582	S	2	0	2	1244604	0.000002	0.000002
Pseudoalteromonas sp. DL-6	1390185	S	1	1	2	1244604	0.000001	0.000002
Pseudoalteromonas sp. Xi13	2490635	S	1	1	2	1244604	0.000001	0.000002
Pseudoalteromonas tunicata	314281	S	2	0	2	1244604	0.000002	0.000002
Pseudoalteromonas xiamenensis	882626	S	2	0	2	1244604	0.000002	0.000002
Pseudoalteromonas ulvae	107327	S	2	0	2	1244604	0.000002	0.000002
Pseudoalteromonas marina	267375	S	1	1	2	1244604	0.000001	0.000002
Pseudoalteromonas undina	43660	S	1	1	2	1244604	0.000001	0.000002
Colwellia sp. 20A7	2689569	S	3	0	3	1244604	0.000002	0.000002
Colwellia sp. PAMC 21821	1816219	S	2	0	2	1244604	0.000002	0.000002
Moritella yayanosii	69539	S	3	0	3	1244604	0.000002	0.000002
Idiomarina andamanensis	1940690	S	2	0	2	1244604	0.000002	0.000002
Vibrio sp. SM1977	2662262	S	2	0	2	1244604	0.000002	0.000002
Vibrio taketomensis	2572923	S	3	0	3	1244604	0.000002	0.000002
Vibrio cincinnatiensis	675	S	3	0	3	1244604	0.000002	0.000002
Vibrio rumoiensis	76258	S	2	0	2	1244604	0.000002	0.000002
Vibrio crassostreae	246167	S	2	0	2	1244604	0.000002	0.000002
Vibrio navarrensis	29495	S	2	0	2	1244604	0.000002	0.000002
Vibrio zhugei	2479546	S	2	0	2	1244604	0.000002	0.000002
Vibrio cyclitrophicus	47951	S	2	0	2	1244604	0.000002	0.000002
Vibrio gazogenes	687	S	2	0	2	1244604	0.000002	0.000002
Photobacterium ganghwense	320778	S	3	0	3	1244604	0.000002	0.000002
Aliivibrio salmonicida	40269	S	3	0	3	1244604	0.000002	0.000002
Stenotrophomonas sp. LM091	1904944	S	3	0	3	1244604	0.000002	0.000002
Stenotrophomonas sp. 364	2691571	S	3	0	3	1244604	0.000002	0.000002
Stenotrophomonas sp. G4	2303750	S	2	0	2	1244604	0.000002	0.000002
Xanthomonas cassavae	56450	S	3	0	3	1244604	0.000002	0.000002
Xanthomonas hyacinthi	56455	S	2	0	2	1244604	0.000002	0.000002
Xanthomonas theicola	56464	S	2	0	2	1244604	0.000002	0.000002
Xanthomonas axonopodis	53413	S	2	0	2	1244604	0.000002	0.000002
Xanthomonas translucens	343	S	2	0	2	1244604	0.000002	0.000002
Xanthomonas vasicola	56459	S	1	1	2	1244604	0.000001	0.000002
Lysobacter sp. H23M47	2781024	S	1	1	2	1244604	0.000001	0.000002
Lysobacter arenosi	2795387	S	3	0	3	1244604	0.000002	0.000002
Lysobacter maris	1605891	S	2	0	2	1244604	0.000002	0.000002
Lysobacter alkalisoli	2591633	S	2	0	2	1244604	0.000002	0.000002
Thermomonas carbonis	1463158	S	3	0	3	1244604	0.000002	0.000002
Luteimonas sp. JM171	1896164	S	3	0	3	1244604	0.000002	0.000002
Luteimonas sp. MC1572	2799325	S	2	0	2	1244604	0.000002	0.000002
Luteimonas chenhongjianii	2006110	S	2	0	2	1244604	0.000002	0.000002
Xylella fastidiosa	2371	S	3	0	3	1244604	0.000002	0.000002
Pseudoxanthomonas suwonensis	314722	S	3	0	3	1244604	0.000002	0.000002
Dyella thiooxydans	445710	S	2	0	2	1244604	0.000002	0.000002
Rhodanobacter denitrificans	666685	S	3	0	3	1244604	0.000002	0.000002
Aerosticca soli	2010829	S	2	0	2	1244604	0.000002	0.000002
Halomonas sp. GFAJ-1	1118153	S	3	0	3	1244604	0.000002	0.000002
Halomonas sp. A40-4	2785909	S	3	0	3	1244604	0.000002	0.000002
Halomonas sp. Y2R2	2562282	S	3	0	3	1244604	0.000002	0.000002
Halomonas sp. YLGW01	2773308	S	2	0	2	1244604	0.000002	0.000002
Halomonas sp. KO116	1504981	S	2	1	3	1244604	0.000002	0.000002
Halomonas sp. SF2003	2136172	S	1	2	3	1244604	0.000001	0.000002
Halomonas subglaciescola	29571	S	3	0	3	1244604	0.000002	0.000002
Halomonas huangheensis	1178482	S	2	0	2	1244604	0.000002	0.000002
Halomonas elongata	2746	S	2	0	2	1244604	0.000002	0.000002
Halomonas alkaliphila	272774	S	1	1	2	1244604	0.000001	0.000002
Chromohalobacter salexigens	158080	S	3	0	3	1244604	0.000002	0.000002
Halotalea alkalilenta	376489	S	3	0	3	1244604	0.000002	0.000002
Neptunomonas phycophila	1572645	S	2	0	2	1244604	0.000002	0.000002
Nitrincola sp. KXZD1103	2614693	S	2	0	2	1244604	0.000002	0.000002
Bacterioplanes sanyensis	1249553	S	2	0	2	1244604	0.000002	0.000002
Alcanivorax sp. N3-2A	2014542	S	3	0	3	1244604	0.000002	0.000002
Alcanivorax pacificus	1306787	S	2	0	2	1244604	0.000002	0.000002
Reinekea forsetii	1336806	S	2	0	2	1244604	0.000002	0.000002
Actinobacillus suis	716	S	3	0	3	1244604	0.000002	0.000002
Actinobacillus indolicus	51049	S	3	0	3	1244604	0.000002	0.000002
Actinobacillus succinogenes	67854	S	3	0	3	1244604	0.000002	0.000002
Actinobacillus pleuropneumoniae	715	S	2	0	2	1244604	0.000002	0.000002
Pasteurella skyensis	97481	S	2	0	2	1244604	0.000002	0.000002
Mannheimia varigena	85404	S	3	0	3	1244604	0.000002	0.000002
Mannheimia haemolytica	75985	S	2	0	2	1244604	0.000002	0.000002
Mannheimia sp. USDA-ARS-USMARC-1261	1432056	S	2	0	2	1244604	0.000002	0.000002
Aggregatibacter actinomycetemcomitans	714	S	3	0	3	1244604	0.000002	0.000002
Aggregatibacter aphrophilus	732	S	2	0	2	1244604	0.000002	0.000002
Rodentibacter sp. DSM 111151	2778911	S	3	0	3	1244604	0.000002	0.000002
Rodentibacter heylii	1906744	S	2	0	2	1244604	0.000002	0.000002
Vespertiliibacter pulmonis	1443036	S	3	0	3	1244604	0.000002	0.000002
Otariodibacter oris	1032623	S	2	0	2	1244604	0.000002	0.000002
Thiomicrorhabdus indica	2267253	S	3	0	3	1244604	0.000002	0.000002
Thiosulfatimonas sediminis	2675054	S	2	0	2	1244604	0.000002	0.000002
Francisella hispaniensis	622488	S	2	0	2	1244604	0.000002	0.000002
Nitrosococcus oceani	1229	S	3	0	3	1244604	0.000002	0.000002
Nitrosococcus watsonii	473531	S	2	0	2	1244604	0.000002	0.000002
Rheinheimera sp. LHK132	2498451	S	3	0	3	1244604	0.000002	0.000002
Rheinheimera sp. D18	2545632	S	2	0	2	1244604	0.000002	0.000002
Candidatus Thiodictyon syntrophicum	1166950	S	2	0	2	1244604	0.000002	0.000002
Thermochromatium tepidum	1050	S	2	0	2	1244604	0.000002	0.000002
Caldichromatium japonicum	2699430	S	2	0	2	1244604	0.000002	0.000002
Thioalkalivibrio sulfidiphilus	1033854	S	3	0	3	1244604	0.000002	0.000002
Thioalkalivibrio sp. K90mix	396595	S	3	0	3	1244604	0.000002	0.000002
Halorhodospira halophila	1053	S	3	0	3	1244604	0.000002	0.000002
Spiribacter salinus	1335746	S	2	0	2	1244604	0.000002	0.000002
Granulosicoccus antarcticus	437505	S	2	0	2	1244604	0.000002	0.000002
Thiohalobacter sp. COW1	2795687	S	1	2	3	1244604	0.000001	0.000002
Guyparkeria halophila	47960	S	2	0	2	1244604	0.000002	0.000002
Cellvibrio sp. PSBB006	1987723	S	3	0	3	1244604	0.000002	0.000002
Cellvibrio sp. KY-YJ-3	454662	S	2	0	2	1244604	0.000002	0.000002
Cellvibrio sp. PSBB023	1945512	S	2	0	2	1244604	0.000002	0.000002
Teredinibacter turnerae	2426	S	2	0	2	1244604	0.000002	0.000002
Simiduia agarivorans	447471	S	2	0	2	1244604	0.000002	0.000002
Microbulbifer sp. YPW1	2745199	S	3	0	3	1244604	0.000002	0.000002
Microbulbifer sp. ALW1	1516059	S	2	0	2	1244604	0.000002	0.000002
Legionella fallonii	96230	S	2	0	2	1244604	0.000002	0.000002
Legionella sainthelensi	28087	S	2	0	2	1244604	0.000002	0.000002
Fluoribacter dumoffii	463	S	3	0	3	1244604	0.000002	0.000002
Aquicella siphonis	254247	S	2	0	2	1244604	0.000002	0.000002
Coxiella burnetii	777	S	2	0	2	1244604	0.000002	0.000002
Methylomicrobium album	39775	S	3	0	3	1244604	0.000002	0.000002
Candidatus Thioglobus sp. NP1	2508687	S	2	0	2	1244604	0.000002	0.000002
Gallaecimonas mangrovi	2291597	S	3	0	3	1244604	0.000002	0.000002
Bathymodiolus septemdierum thioautotrophic gill symbiont	113267	S	2	0	2	1244604	0.000002	0.000002
Candidatus Reidiella endopervernicosa	2738883	S	2	0	2	1244604	0.000002	0.000002
Solimonas sp. K1W22B-7	2303331	S	3	0	3	1244604	0.000002	0.000002
Steroidobacter denitrificans	465721	S	3	0	3	1244604	0.000002	0.000002
Cardiobacterium hominis	2718	S	2	0	2	1244604	0.000002	0.000002
Hydrogenophaga sp. PAMC20947	2565558	S	2	0	2	1244604	0.000002	0.000002
Variovorax sp. PAMC 28711	1795631	S	3	0	3	1244604	0.000002	0.000002
Variovorax sp. 38R	2774875	S	2	0	2	1244604	0.000002	0.000002
Rhodoferax sp. BAB1	2741720	S	3	0	3	1244604	0.000002	0.000002
Rhodoferax antarcticus	81479	S	2	0	2	1244604	0.000002	0.000002
Rhodoferax ferrireducens	192843	S	2	0	2	1244604	0.000002	0.000002
Curvibacter sp. AEP1-3	1844971	S	3	0	3	1244604	0.000002	0.000002
Schlegelella thermodepolymerans	215580	S	2	0	2	1244604	0.000002	0.000002
Burkholderia sp. CCGE1003	640512	S	3	0	3	1244604	0.000002	0.000002
Burkholderia sp. Bp7605	1740163	S	2	0	2	1244604	0.000002	0.000002
Burkholderia sp. DHOD12	2571746	S	2	0	2	1244604	0.000002	0.000002
Burkholderia sp. KK1	1855726	S	1	1	2	1244604	0.000001	0.000002
Burkholderia sp. BDU6	1385591	S	2	0	2	1244604	0.000002	0.000002
Cupriavidus neocaledonicus	1040979	S	3	0	3	1244604	0.000002	0.000002
Cupriavidus nantongensis	1796606	S	2	0	2	1244604	0.000002	0.000002
Cupriavidus malaysiensis	367825	S	1	2	3	1244604	0.000001	0.000002
Paraburkholderia sp. SOS3	1926494	S	2	0	2	1244604	0.000002	0.000002
Paraburkholderia sp. PGU16	2735433	S	2	0	2	1244604	0.000002	0.000002
Paraburkholderia sp. PGU19	2735434	S	2	0	2	1244604	0.000002	0.000002
Paraburkholderia ginsengisoli	311231	S	3	0	3	1244604	0.000002	0.000002
Paraburkholderia acidophila	265293	S	2	0	2	1244604	0.000002	0.000002
Paraburkholderia acidisoli	2571748	S	2	0	2	1244604	0.000002	0.000002
Paraburkholderia dokdonella	2211211	S	2	0	2	1244604	0.000002	0.000002
Paraburkholderia atlantica	2654982	S	2	0	2	1244604	0.000002	0.000002
Paraburkholderia caffeinilytica	1761016	S	2	0	2	1244604	0.000002	0.000002
Paraburkholderia sprentiae	948107	S	2	0	2	1244604	0.000002	0.000002
Pandoraea norimbergensis	93219	S	2	0	2	1244604	0.000002	0.000002
Pandoraea oxalativorans	573737	S	2	0	2	1244604	0.000002	0.000002
Pandoraea faecigallinarum	656179	S	2	0	2	1244604	0.000002	0.000002
Ralstonia mannitolilytica	105219	S	2	0	2	1244604	0.000002	0.000002
Polynucleobacter difficilis	556054	S	2	0	2	1244604	0.000002	0.000002
Polynucleobacter asymbioticus	576611	S	2	0	2	1244604	0.000002	0.000002
Caballeronia insecticola	758793	S	2	0	2	1244604	0.000002	0.000002
Chitinimonas arctica	2594795	S	3	0	3	1244604	0.000002	0.000002
Achromobacter insolitus	217204	S	3	0	3	1244604	0.000002	0.000002
Bordetella sp. H567	1697043	S	2	0	2	1244604	0.000002	0.000002
Bordetella trematum	123899	S	3	0	3	1244604	0.000002	0.000002
Bordetella genomosp. 9	1416803	S	3	0	3	1244604	0.000002	0.000002
Bordetella pseudohinzii	1331258	S	2	0	2	1244604	0.000002	0.000002
Bordetella parapertussis	519	S	1	1	2	1244604	0.000001	0.000002
Alcaligenes sp. SORT26	2813780	S	2	0	2	1244604	0.000002	0.000002
Pusillimonas sp. T7-7	1007105	S	3	0	3	1244604	0.000002	0.000002
Pusillimonas sp. DMV24BSW_D	2716226	S	2	0	2	1244604	0.000002	0.000002
Algicoccus marinus	2163011	S	3	0	3	1244604	0.000002	0.000002
Kerstersia gyiorum	206506	S	2	0	2	1244604	0.000002	0.000002
Massilia sp. CCM 8941	2765360	S	3	0	3	1244604	0.000002	0.000002
Massilia sp. NR 4-1	1678028	S	2	0	2	1244604	0.000002	0.000002
Massilia sp. WG5	1707785	S	2	0	2	1244604	0.000002	0.000002
Massilia sp. LPB0304	2769491	S	2	0	2	1244604	0.000002	0.000002
Massilia albidiflava	321983	S	3	0	3	1244604	0.000002	0.000002
Massilia flava	871742	S	3	0	3	1244604	0.000002	0.000002
Massilia violaceinigra	2045208	S	3	0	3	1244604	0.000002	0.000002
Massilia lutea	321985	S	2	0	2	1244604	0.000002	0.000002
Massilia putida	1141883	S	2	0	2	1244604	0.000002	0.000002
Massilia armeniaca	2072590	S	2	0	2	1244604	0.000002	0.000002
Herbaspirillum frisingense	92645	S	3	0	3	1244604	0.000002	0.000002
Janthinobacterium sp. HH102	1537274	S	3	0	3	1244604	0.000002	0.000002
Janthinobacterium sp. 17J80-10	2497863	S	3	0	3	1244604	0.000002	0.000002
Janthinobacterium sp. Marseille	375286	S	2	0	2	1244604	0.000002	0.000002
Collimonas pratensis	279113	S	3	0	3	1244604	0.000002	0.000002
Duganella sp. GN2-R2	2728020	S	2	0	2	1244604	0.000002	0.000002
Duganella sp. AF9R3	2728021	S	2	0	2	1244604	0.000002	0.000002
Noviherbaspirillum sp. UKPF54	2601898	S	3	0	3	1244604	0.000002	0.000002
Oxalobacter formigenes	847	S	2	0	2	1244604	0.000002	0.000002
Methylibium petroleiphilum	105560	S	2	1	3	1244604	0.000002	0.000002
Rhizobacter gummiphilus	946333	S	3	0	3	1244604	0.000002	0.000002
Paucibacter sp. KCTC 42545	1768242	S	2	0	2	1244604	0.000002	0.000002
Sutterella megalosphaeroides	2494234	S	3	0	3	1244604	0.000002	0.000002
Chromobacterium paludis	2605945	S	3	0	3	1244604	0.000002	0.000002
Aquitalea sp. USM4	1590041	S	2	0	2	1244604	0.000002	0.000002
Deefgea sp. D17	2739061	S	2	0	2	1244604	0.000002	0.000002
Neisseria sp. KEM232	655307	S	2	0	2	1244604	0.000002	0.000002
Neisseria elongata	495	S	3	0	3	1244604	0.000002	0.000002
Neisseria animaloris	326522	S	2	0	2	1244604	0.000002	0.000002
Neisseria weaveri	28091	S	2	0	2	1244604	0.000002	0.000002
Simonsiella muelleri	72	S	3	0	3	1244604	0.000002	0.000002
Eikenella corrodens	539	S	3	0	3	1244604	0.000002	0.000002
Kingella oralis	505	S	2	0	2	1244604	0.000002	0.000002
Azoarcus sp. DD4	2027405	S	3	0	3	1244604	0.000002	0.000002
Fluviibacter phosphoraccumulans	1751046	S	3	0	3	1244604	0.000002	0.000002
Denitratisoma oestradiolicum	311182	S	3	0	3	1244604	0.000002	0.000002
Methyloversatilis sp. RAC08	1842540	S	2	0	2	1244604	0.000002	0.000002
Nitrosospira lacus	1288494	S	3	0	3	1244604	0.000002	0.000002
Nitrosomonas sp. Is79A3	261292	S	3	0	3	1244604	0.000002	0.000002
Gallionella capsiferriformans	370405	S	3	0	3	1244604	0.000002	0.000002
Usitatibacter palustris	2732487	S	3	0	3	1244604	0.000002	0.000002
Usitatibacter rugosus	2732067	S	2	0	2	1244604	0.000002	0.000002
Methylovorus glucosotrophus	266009	S	1	1	2	1244604	0.000001	0.000002
Sulfuricella denitrificans	649841	S	2	0	2	1244604	0.000002	0.000002
Sulfuritortus calidifontis	1914471	S	3	0	3	1244604	0.000002	0.000002
Candidatus Kinetoplastibacterium blastocrithidii	233181	S	3	0	3	1244604	0.000002	0.000002
Candidatus Kinetoplastibacterium desouzaii	994692	S	3	0	3	1244604	0.000002	0.000002
Candidatus Kinetoplastibacterium oncopeltii	994696	S	2	0	2	1244604	0.000002	0.000002
Casimicrobium huifangae	2591109	S	3	0	3	1244604	0.000002	0.000002
Brucella intermedia	94625	S	2	0	2	1244604	0.000002	0.000002
Rhizobium sp. BG4	2613770	S	3	0	3	1244604	0.000002	0.000002
Rhizobium sp. WL3	2603277	S	3	0	3	1244604	0.000002	0.000002
Rhizobium sp. ACO-34A	1571470	S	2	0	2	1244604	0.000002	0.000002
Rhizobium tropici	398	S	2	0	2	1244604	0.000002	0.000002
Rhizobium gallicum	56730	S	2	1	3	1244604	0.000002	0.000002
Rhizobium lusitanum	293958	S	2	0	2	1244604	0.000002	0.000002
Rhizobium jaguaris	1312183	S	2	0	2	1244604	0.000002	0.000002
Agrobacterium larrymoorei	160699	S	3	0	3	1244604	0.000002	0.000002
Agrobacterium sp. CGMCC 11546	2579248	S	1	1	2	1244604	0.000001	0.000002
Sinorhizobium meliloti	382	S	2	0	2	1244604	0.000002	0.000002
Ensifer sojae	716925	S	3	0	3	1244604	0.000002	0.000002
Ensifer sp. PDNC004	2811423	S	2	0	2	1244604	0.000002	0.000002
Liberibacter crescens	1273132	S	2	0	2	1244604	0.000002	0.000002
Shinella sp. HZN7	879274	S	2	0	2	1244604	0.000002	0.000002
Bradyrhizobium sp. ORS 285	115808	S	3	0	3	1244604	0.000002	0.000002
Bradyrhizobium sp. CCBAU 51765	1325102	S	3	0	3	1244604	0.000002	0.000002
Bradyrhizobium sp. CCBAU 53340	1325112	S	2	0	2	1244604	0.000002	0.000002
Bradyrhizobium sp. CCBAU 53421	1325120	S	2	0	2	1244604	0.000002	0.000002
Bradyrhizobium sp. CCBAU 53351	1325114	S	2	0	2	1244604	0.000002	0.000002
Bradyrhizobium sp.	376	S	2	0	2	1244604	0.000002	0.000002
Bradyrhizobium sp. CCGE-LA001	1223566	S	2	0	2	1244604	0.000002	0.000002
Bradyrhizobium genosp. B	83627	S	2	0	2	1244604	0.000002	0.000002
Bradyrhizobium symbiodeficiens	1404367	S	2	0	2	1244604	0.000002	0.000002
Bradyrhizobium japonicum	375	S	2	0	2	1244604	0.000002	0.000002
Bradyrhizobium guangdongense	1325090	S	2	1	3	1244604	0.000002	0.000002
Bradyrhizobium guangxiense	1325115	S	2	0	2	1244604	0.000002	0.000002
Bosea sp. RAC05	1842539	S	2	0	2	1244604	0.000002	0.000002
Bosea sp. ANAM02	2020412	S	2	0	2	1244604	0.000002	0.000002
Bosea vaviloviae	1526658	S	2	0	2	1244604	0.000002	0.000002
Variibacter gotjawalensis	1333996	S	2	0	2	1244604	0.000002	0.000002
Mesorhizobium sp. Pch-S	2082387	S	3	0	3	1244604	0.000002	0.000002
Mesorhizobium sp. 131-2-1	2744518	S	3	0	3	1244604	0.000002	0.000002
Mesorhizobium sp. M1A.F.Ca.IN.022.06.1.1	2493680	S	2	0	2	1244604	0.000002	0.000002
Mesorhizobium sp. M6A.T.Cr.TU.016.01.1.1	2493677	S	2	0	2	1244604	0.000002	0.000002
Mesorhizobium sp. L-8-10	2744523	S	1	1	2	1244604	0.000001	0.000002
Mesorhizobium oceanicum	1670800	S	3	0	3	1244604	0.000002	0.000002
Mesorhizobium amorphae	71433	S	2	0	2	1244604	0.000002	0.000002
Mesorhizobium opportunistum	593909	S	2	0	2	1244604	0.000002	0.000002
Nitratireductor sp. SY7	2599600	S	3	0	3	1244604	0.000002	0.000002
Phyllobacterium zundukense	1867719	S	2	0	2	1244604	0.000002	0.000002
Hoeflea phototrophica	244596	S	2	0	2	1244604	0.000002	0.000002
Methylobacterium sp. WL1	2603276	S	3	0	3	1244604	0.000002	0.000002
Methylobacterium nodulans	114616	S	3	0	3	1244604	0.000002	0.000002
Methylobacterium durans	2202825	S	2	0	2	1244604	0.000002	0.000002
Microvirga ossetica	1882682	S	3	0	3	1244604	0.000002	0.000002
Microvirga thermotolerans	2651334	S	2	0	2	1244604	0.000002	0.000002
Devosia sp. A16	1736675	S	3	0	3	1244604	0.000002	0.000002
Devosia sp. I507	2083786	S	3	0	3	1244604	0.000002	0.000002
Starkeya sp. ORNL1	2709380	S	3	0	3	1244604	0.000002	0.000002
Martelella endophytica	1486262	S	2	0	2	1244604	0.000002	0.000002
Aureimonas sp. OT7	2816454	S	2	0	2	1244604	0.000002	0.000002
Labrenzia sp. PHM005	2590016	S	2	1	3	1244604	0.000002	0.000002
Labrenzia sp. VG12	2021862	S	1	1	2	1244604	0.000001	0.000002
Nordella sp. HKS 07	2712222	S	3	0	3	1244604	0.000002	0.000002
Methylocella silvestris	199596	S	2	0	2	1244604	0.000002	0.000002
Methylovirgula ligni	569860	S	2	0	2	1244604	0.000002	0.000002
Paracoccus sp. MC1862	2760307	S	3	0	3	1244604	0.000002	0.000002
Paracoccus sp. H4-D09	2812658	S	2	0	2	1244604	0.000002	0.000002
Paracoccus contaminans	1945662	S	3	0	3	1244604	0.000002	0.000002
Paracoccus sanguinis	1545044	S	3	0	3	1244604	0.000002	0.000002
Paracoccus yeei	147645	S	3	0	3	1244604	0.000002	0.000002
Paracoccus zhejiangensis	1077935	S	2	0	2	1244604	0.000002	0.000002
Sulfitobacter sp. B30-2	2785912	S	2	0	2	1244604	0.000002	0.000002
Sulfitobacter mediterraneus	83219	S	3	0	3	1244604	0.000002	0.000002
Sulfitobacter pseudonitzschiae	1402135	S	2	0	2	1244604	0.000002	0.000002
Phaeobacter inhibens	221822	S	2	1	3	1244604	0.000002	0.000002
Celeribacter indicus	1208324	S	2	1	3	1244604	0.000002	0.000002
Octadecabacter arcticus	53946	S	2	0	2	1244604	0.000002	0.000002
Rhodovulum sp. MB263	308754	S	2	0	2	1244604	0.000002	0.000002
Rhodovulum sp. P5	1564506	S	2	0	2	1244604	0.000002	0.000002
Thioclava electrotropha	1549850	S	2	0	2	1244604	0.000002	0.000002
Profundibacter amoris	2171755	S	3	0	3	1244604	0.000002	0.000002
Roseicitreum antarcticum	564137	S	3	0	3	1244604	0.000002	0.000002
Defluviimonas alba	1335048	S	3	0	3	1244604	0.000002	0.000002
Rhodobacter capsulatus	1061	S	2	0	2	1244604	0.000002	0.000002
Parasedimentitalea marina	2483033	S	2	0	2	1244604	0.000002	0.000002
Maribius sp. THAF1	2587842	S	2	0	2	1244604	0.000002	0.000002
Pelagovum pacificum	2588711	S	2	0	2	1244604	0.000002	0.000002
Boseongicola sp. CCM32	2552942	S	2	0	2	1244604	0.000002	0.000002
Polymorphum gilvum	991904	S	2	0	2	1244604	0.000002	0.000002
Sphingomonas sp. CL5.1	2653203	S	3	0	3	1244604	0.000002	0.000002
Sphingomonas sp. Cra20	1327635	S	3	0	3	1244604	0.000002	0.000002
Sphingomonas sp. LK11	1390395	S	3	0	3	1244604	0.000002	0.000002
Sphingomonas sp. KC8	1030157	S	2	0	2	1244604	0.000002	0.000002
Sphingomonas sp. HMP6	1517551	S	2	0	2	1244604	0.000002	0.000002
Sphingomonas sp. NIC1	1961362	S	2	1	3	1244604	0.000002	0.000002
Sphingomonas wittichii	160791	S	2	0	2	1244604	0.000002	0.000002
Sphingomonas ginsengisoli An et al. 2013	363835	S	2	0	2	1244604	0.000002	0.000002
Sphingomonas sediminicola	386874	S	2	0	2	1244604	0.000002	0.000002
Sphingomonas hengshuiensis	1609977	S	2	0	2	1244604	0.000002	0.000002
Sphingobium sp. TKS	1315974	S	3	0	3	1244604	0.000002	0.000002
Sphingobium sp. SYK-6	627192	S	2	0	2	1244604	0.000002	0.000002
Sphingobium sp. YG1	2082188	S	2	0	2	1244604	0.000002	0.000002
Sphingobium herbicidovorans	76947	S	3	0	3	1244604	0.000002	0.000002
Sphingopyxis sp. QXT-31	1357916	S	3	0	3	1244604	0.000002	0.000002
Novosphingobium aromaticivorans	48935	S	1	1	2	1244604	0.000001	0.000002
Sphingosinithalassobacter sp. zrk23	2711215	S	3	0	3	1244604	0.000002	0.000002
Sphingosinithalassobacter sp. CS137	2762748	S	2	0	2	1244604	0.000002	0.000002
Blastomonas fulva	1550728	S	1	1	2	1244604	0.000001	0.000002
Novosphingopyxis sp. PB63	2762729	S	2	0	2	1244604	0.000002	0.000002
Tsuneonella amylolytica	2338327	S	3	0	3	1244604	0.000002	0.000002
Tsuneonella dongtanensis	692370	S	2	0	2	1244604	0.000002	0.000002
Tsuneonella mangrovi	1982042	S	2	0	2	1244604	0.000002	0.000002
Croceicoccus marinus	450378	S	2	0	2	1244604	0.000002	0.000002
Porphyrobacter sp. CACIAM 03H1	2003315	S	2	0	2	1244604	0.000002	0.000002
Erythrobacter neustonensis	1112	S	2	0	2	1244604	0.000002	0.000002
Altererythrobacter sp. B11	2060312	S	2	0	2	1244604	0.000002	0.000002
Sphingosinicella microcystinivorans	335406	S	2	0	2	1244604	0.000002	0.000002
Azospirillum sp. TSH58	664962	S	2	0	2	1244604	0.000002	0.000002
Azospirillum thiophilum	528244	S	2	0	2	1244604	0.000002	0.000002
Magnetospirillum magneticum	84159	S	2	0	2	1244604	0.000002	0.000002
Magnetospirillum sp. ME-1	1639348	S	1	1	2	1244604	0.000001	0.000002
Hypericibacter adhaerens	2602016	S	3	0	3	1244604	0.000002	0.000002
Rhodospirillum centenum	34018	S	2	0	2	1244604	0.000002	0.000002
Pararhodospirillum photometricum	1084	S	3	0	3	1244604	0.000002	0.000002
Niveispirillum cyanobacteriorum	1612173	S	2	0	2	1244604	0.000002	0.000002
Acetobacter senegalensis	446692	S	3	0	3	1244604	0.000002	0.000002
Acetobacter aceti	435	S	2	0	2	1244604	0.000002	0.000002
Roseomonas sp. 1318	2768161	S	3	0	3	1244604	0.000002	0.000002
Komagataeibacter medellinensis	1177712	S	3	0	3	1244604	0.000002	0.000002
Entomobacter blattae	2762277	S	3	0	3	1244604	0.000002	0.000002
Gluconobacter albidus	318683	S	1	2	3	1244604	0.000001	0.000002
Roseococcus sp. NIBR12	2771361	S	2	0	2	1244604	0.000002	0.000002
Brevundimonas sp. LVF1	2774189	S	3	0	3	1244604	0.000002	0.000002
Brevundimonas naejangsanensis	588932	S	2	0	2	1244604	0.000002	0.000002
Caulobacter flavus	1679497	S	3	0	3	1244604	0.000002	0.000002
Caulobacter mirabilis	69666	S	2	0	2	1244604	0.000002	0.000002
Caulobacter vibrioides	155892	S	2	0	2	1244604	0.000002	0.000002
Caulobacter sp. K31	366602	S	2	0	2	1244604	0.000002	0.000002
Asticcacaulis excentricus	78587	S	2	0	2	1244604	0.000002	0.000002
Candidatus Cytomitobacter primus	2066024	S	2	0	2	1244604	0.000002	0.000002
Candidatus Pelagibacter ubique	198252	S	3	0	3	1244604	0.000002	0.000002
Phreatobacter stygius	1940610	S	2	0	2	1244604	0.000002	0.000002
Candidatus Puniceispirillum marinum	767892	S	2	0	2	1244604	0.000002	0.000002
Marinicauda algicola	2029849	S	3	0	3	1244604	0.000002	0.000002
Hyphobacterium sp. CCMP332	2749086	S	2	0	2	1244604	0.000002	0.000002
Paremcibacter congregatus	2043170	S	2	0	2	1244604	0.000002	0.000002
Aliarcobacter skirrowii	28200	S	2	1	3	1244604	0.000002	0.000002
Aliarcobacter thereius	544718	S	1	1	2	1244604	0.000001	0.000002
Arcobacter venerupis	1054033	S	3	0	3	1244604	0.000002	0.000002
Arcobacter aquimarinus	1315211	S	3	0	3	1244604	0.000002	0.000002
Arcobacter cloacae	1054034	S	2	0	2	1244604	0.000002	0.000002
Campylobacter sp. 2014D-0216	1813595	S	1	1	2	1244604	0.000001	0.000002
Sulfurospirillum halorespirans	194424	S	3	0	3	1244604	0.000002	0.000002
Sulfurimonas denitrificans	39766	S	3	0	3	1244604	0.000002	0.000002
Helicobacter winghamensis	157268	S	3	0	3	1244604	0.000002	0.000002
Helicobacter apodemus	135569	S	3	0	3	1244604	0.000002	0.000002
Helicobacter typhlonius	76936	S	2	0	2	1244604	0.000002	0.000002
Wolinella succinogenes	844	S	3	0	3	1244604	0.000002	0.000002
Hydrogenimonas urashimensis	2740515	S	2	0	2	1244604	0.000002	0.000002
Nitratiruptor labii	2706014	S	3	0	3	1244604	0.000002	0.000002
Stigmatella aurantiaca	41	S	3	0	3	1244604	0.000002	0.000002
Archangium violaceum	83451	S	3	0	3	1244604	0.000002	0.000002
Melittangium boletus	83453	S	2	0	2	1244604	0.000002	0.000002
Corallococcus coralloides	184914	S	2	0	2	1244604	0.000002	0.000002
Pyxidicoccus sp. SCPEA002	2813578	S	2	0	2	1244604	0.000002	0.000002
Anaeromyxobacter sp. Fw109-5	404589	S	2	1	3	1244604	0.000002	0.000002
Chondromyces crocatus	52	S	3	0	3	1244604	0.000002	0.000002
Desulfobacter hydrogenophilus	2291	S	3	0	3	1244604	0.000002	0.000002
Desulfonema magnum	45655	S	3	0	3	1244604	0.000002	0.000002
Desulfobulbus propionicus	894	S	2	0	2	1244604	0.000002	0.000002
Desulfovibrio carbinolicus	296842	S	3	0	3	1244604	0.000002	0.000002
Desulfovibrio vulgaris	881	S	2	0	2	1244604	0.000002	0.000002
Desulfovibrio magneticus	184917	S	2	0	2	1244604	0.000002	0.000002
Pseudodesulfovibrio aespoeensis	182210	S	2	0	2	1244604	0.000002	0.000002
Maridesulfovibrio salexigens	880	S	3	0	3	1244604	0.000002	0.000002
Desulfolutivibrio sulfoxidireducens	2773299	S	2	0	2	1244604	0.000002	0.000002
Desulfohalobium retbaense	45663	S	2	0	2	1244604	0.000002	0.000002
Geobacter sp. DSM 9736	1277350	S	2	0	2	1244604	0.000002	0.000002
Geobacter sp. SVR	2495594	S	2	0	2	1244604	0.000002	0.000002
Pelobacter propionicus	29543	S	2	0	2	1244604	0.000002	0.000002
Persicimonas caeni	2292766	S	2	0	2	1244604	0.000002	0.000002
Candidatus Desulfofervidus auxilii	1621989	S	2	0	2	1244604	0.000002	0.000002
Acidithiobacillus caldus	33059	S	3	0	3	1244604	0.000002	0.000002
Acidithiobacillus thiooxidans	930	S	2	1	3	1244604	0.000002	0.000002
Bacillus sp. Cs-700	2589818	S	3	0	3	1244604	0.000002	0.000002
Bacillus sp. PAMC26568	2760090	S	3	0	3	1244604	0.000002	0.000002
Bacillus sp. COPE52	2233998	S	2	0	2	1244604	0.000002	0.000002
Bacillus sp. FJAT-18017	1705566	S	2	0	2	1244604	0.000002	0.000002
Bacillus sp. FJAT-45348	2011012	S	2	0	2	1244604	0.000002	0.000002
Bacillus sp. S3	486398	S	2	0	2	1244604	0.000002	0.000002
Bacillus sp. A260	2660750	S	1	2	3	1244604	0.000001	0.000002
Bacillus sp. B25(2016b)	1868655	S	1	1	2	1244604	0.000001	0.000002
Bacillus velezensis	492670	S	1	1	2	1244604	0.000001	0.000002
Bacillus mojavensis	72360	S	2	0	2	1244604	0.000002	0.000002
Bacillus sonorensis	119858	S	2	0	2	1244604	0.000002	0.000002
Bacillus paralicheniformis	1648923	S	2	0	2	1244604	0.000002	0.000002
Bacillus licheniformis	1402	S	1	1	2	1244604	0.000001	0.000002
Bacillus marisflavi	189381	S	3	0	3	1244604	0.000002	0.000002
Bacillus glycinifermentans	1664069	S	3	0	3	1244604	0.000002	0.000002
Bacillus vini	1476025	S	3	0	3	1244604	0.000002	0.000002
Bacillus cohnii	33932	S	2	0	2	1244604	0.000002	0.000002
[Brevibacterium] frigoritolerans	450367	S	1	1	2	1244604	0.000001	0.000002
Peribacillus muralis	264697	S	2	0	2	1244604	0.000002	0.000002
Virgibacillus phasianinus	2017483	S	3	0	3	1244604	0.000002	0.000002
Virgibacillus pantothenticus	1473	S	1	2	3	1244604	0.000001	0.000002
Alkalihalobacillus lehensis	300825	S	2	0	2	1244604	0.000002	0.000002
Metabacillus litoralis	152268	S	2	0	2	1244604	0.000002	0.000002
Halobacillus halophilus	1570	S	3	0	3	1244604	0.000002	0.000002
Neobacillus cucumis	1740721	S	3	0	3	1244604	0.000002	0.000002
Geobacillus sp. E263	391290	S	1	1	2	1244604	0.000001	0.000002
Geobacillus stearothermophilus	1422	S	2	0	2	1244604	0.000002	0.000002
Oceanobacillus kimchii	746691	S	1	1	2	1244604	0.000001	0.000002
Salicibibacter sp. NKC21-4	2743001	S	3	0	3	1244604	0.000002	0.000002
Pontibacillus sp. ALD_SL1	2777185	S	2	0	2	1244604	0.000002	0.000002
Gracilibacillus sp. SCU50	2663022	S	3	0	3	1244604	0.000002	0.000002
Lentibacillus sp. CBA3610	2518176	S	2	0	2	1244604	0.000002	0.000002
Cytobacillus oceanisediminis	665099	S	2	0	2	1244604	0.000002	0.000002
Sediminibacillus sp. DP4-553-S	2729421	S	2	0	2	1244604	0.000002	0.000002
Salimicrobium jeotgali	1230341	S	2	0	2	1244604	0.000002	0.000002
Mesobacillus jeotgali	129985	S	2	0	2	1244604	0.000002	0.000002
Kurthia zopfii	1650	S	2	0	2	1244604	0.000002	0.000002
Sporosarcina pasteurii	1474	S	3	0	3	1244604	0.000002	0.000002
Sporosarcina ureilytica	298596	S	2	0	2	1244604	0.000002	0.000002
Sporosarcina psychrophila	1476	S	1	1	2	1244604	0.000001	0.000002
Planococcus kocurii	1374	S	3	0	3	1244604	0.000002	0.000002
Planococcus antarcticus	161360	S	3	0	3	1244604	0.000002	0.000002
Planococcus donghaensis	414778	S	3	0	3	1244604	0.000002	0.000002
Ureibacillus thermosphaericus	51173	S	3	0	3	1244604	0.000002	0.000002
Planomicrobium glaciei	459472	S	2	0	2	1244604	0.000002	0.000002
Paenibacillus sp. JDR-2	324057	S	3	0	3	1244604	0.000002	0.000002
Paenibacillus sp. 37	2607911	S	3	0	3	1244604	0.000002	0.000002
Paenibacillus sp. BIHB4019	1870819	S	3	0	3	1244604	0.000002	0.000002
Paenibacillus sp. 32O-W	1695218	S	3	0	3	1244604	0.000002	0.000002
Paenibacillus sp. FSL R7-0273	1536772	S	2	0	2	1244604	0.000002	0.000002
Paenibacillus sp. FSL R5-0345	1536770	S	2	0	2	1244604	0.000002	0.000002
Paenibacillus sp. FSL P4-0081	1536769	S	2	0	2	1244604	0.000002	0.000002
Paenibacillus sp. Cedars	1980674	S	1	1	2	1244604	0.000001	0.000002
Paenibacillus ihbetae	1870820	S	3	0	3	1244604	0.000002	0.000002
Paenibacillus physcomitrellae	1619311	S	3	0	3	1244604	0.000002	0.000002
Paenibacillus brasilensis	128574	S	2	0	2	1244604	0.000002	0.000002
Paenibacillus protaetiae	2509456	S	2	0	2	1244604	0.000002	0.000002
Paenibacillus crassostreae	1763538	S	2	0	2	1244604	0.000002	0.000002
Paenibacillus baekrokdamisoli	1712516	S	2	0	2	1244604	0.000002	0.000002
Paenibacillus thiaminolyticus	49283	S	2	0	2	1244604	0.000002	0.000002
Paenibacillus beijingensis	1126833	S	2	0	2	1244604	0.000002	0.000002
Paenibacillus cellulositrophicus	562959	S	2	0	2	1244604	0.000002	0.000002
Paenibacillus donghaensis	414771	S	2	0	2	1244604	0.000002	0.000002
Aneurinibacillus soli	1500254	S	3	0	3	1244604	0.000002	0.000002
Listeria ivanovii	1638	S	3	0	3	1244604	0.000002	0.000002
Staphylococcus simiae	308354	S	3	0	3	1244604	0.000002	0.000002
Staphylococcus arlettae	29378	S	3	0	3	1244604	0.000002	0.000002
Staphylococcus hominis	1290	S	3	0	3	1244604	0.000002	0.000002
Staphylococcus haemolyticus	1283	S	3	0	3	1244604	0.000002	0.000002
Staphylococcus epidermidis	1282	S	3	0	3	1244604	0.000002	0.000002
Staphylococcus agnetis	985762	S	2	0	2	1244604	0.000002	0.000002
Staphylococcus capitis	29388	S	2	0	2	1244604	0.000002	0.000002
Mammaliicoccus stepanovicii	643214	S	2	0	2	1244604	0.000002	0.000002
Macrococcus sp. IME1552	1898474	S	3	0	3	1244604	0.000002	0.000002
Jeotgalicoccus saudimassiliensis	1461582	S	3	0	3	1244604	0.000002	0.000002
Alicyclobacillus ferrooxydans	471514	S	2	0	2	1244604	0.000002	0.000002
Enterococcus mundtii	53346	S	3	0	3	1244604	0.000002	0.000002
Enterococcus wangshanyuanii	2005703	S	3	0	3	1244604	0.000002	0.000002
Enterococcus sp.	35783	S	1	1	2	1244604	0.000001	0.000002
Vagococcus penaei	633807	S	2	0	2	1244604	0.000002	0.000002
Tetragenococcus halophilus	51669	S	2	0	2	1244604	0.000002	0.000002
Melissococcus plutonius	33970	S	3	0	3	1244604	0.000002	0.000002
Lactobacillus iners	147802	S	3	0	3	1244604	0.000002	0.000002
Lactobacillus amylovorus	1604	S	2	0	2	1244604	0.000002	0.000002
Lactobacillus johnsonii	33959	S	2	0	2	1244604	0.000002	0.000002
Companilactobacillus zhachilii	2304606	S	3	0	3	1244604	0.000002	0.000002
Ligilactobacillus salivarius	1624	S	3	0	3	1244604	0.000002	0.000002
Paucilactobacillus oligofermentans	293371	S	3	0	3	1244604	0.000002	0.000002
Paucilactobacillus nenjiangensis	1296540	S	3	0	3	1244604	0.000002	0.000002
Latilactobacillus sakei	1599	S	2	0	2	1244604	0.000002	0.000002
Latilactobacillus curvatus	28038	S	2	0	2	1244604	0.000002	0.000002
Lacticaseibacillus zeae	57037	S	2	0	2	1244604	0.000002	0.000002
Oenococcus sicerae	2203724	S	2	0	2	1244604	0.000002	0.000002
Levilactobacillus brevis	1580	S	3	0	3	1244604	0.000002	0.000002
Streptococcus sp. oral taxon 061	712623	S	2	0	2	1244604	0.000002	0.000002
Streptococcus thermophilus	1308	S	3	0	3	1244604	0.000002	0.000002
Streptococcus pluranimalium	82348	S	3	0	3	1244604	0.000002	0.000002
Streptococcus ratti	1341	S	3	0	3	1244604	0.000002	0.000002
Streptococcus oralis	1303	S	2	0	2	1244604	0.000002	0.000002
Streptococcus periodonticum	2490633	S	2	1	3	1244604	0.000002	0.000002
Streptococcus urinalis	149016	S	2	0	2	1244604	0.000002	0.000002
Streptococcus gordonii	1302	S	2	0	2	1244604	0.000002	0.000002
Lactococcus allomyrinae	2419773	S	3	0	3	1244604	0.000002	0.000002
Lactococcus lactis	1358	S	2	0	2	1244604	0.000002	0.000002
Jeotgalibaca porci	1868793	S	2	0	2	1244604	0.000002	0.000002
Aerococcus urinaeequi	51665	S	2	0	2	1244604	0.000002	0.000002
Clostridium sp. 'deep sea'	2779445	S	3	0	3	1244604	0.000002	0.000002
Clostridium sp. BNL1100	755731	S	2	0	2	1244604	0.000002	0.000002
Clostridium sp. CT4	2320868	S	2	0	2	1244604	0.000002	0.000002
Clostridium cochlearium	1494	S	3	0	3	1244604	0.000002	0.000002
Clostridium bornimense	1216932	S	3	0	3	1244604	0.000002	0.000002
Clostridium drakei	332101	S	3	0	3	1244604	0.000002	0.000002
Clostridium saccharobutylicum	169679	S	2	0	2	1244604	0.000002	0.000002
Clostridium septicum	1504	S	2	0	2	1244604	0.000002	0.000002
Clostridium intestinale	36845	S	2	0	2	1244604	0.000002	0.000002
Clostridium argentinense	29341	S	2	0	2	1244604	0.000002	0.000002
Clostridium sporogenes	1509	S	1	2	3	1244604	0.000001	0.000002
Caloranaerobacter azorensis	116090	S	2	0	2	1244604	0.000002	0.000002
Crassaminicella sp. SY095	2599308	S	2	0	2	1244604	0.000002	0.000002
Romboutsia hominis	1507512	S	2	0	2	1244604	0.000002	0.000002
Filifactor alocis	143361	S	2	0	2	1244604	0.000002	0.000002
[Ruminococcus] torques	33039	S	3	0	3	1244604	0.000002	0.000002
Blautia sp. LZLJ-3	2779518	S	2	0	2	1244604	0.000002	0.000002
[Clostridium] scindens	29347	S	2	0	2	1244604	0.000002	0.000002
Butyrivibrio fibrisolvens	831	S	2	0	2	1244604	0.000002	0.000002
Coprococcus catus	116085	S	2	0	2	1244604	0.000002	0.000002
Ruminiclostridium cellulolyticum	1521	S	2	0	2	1244604	0.000002	0.000002
Acetivibrio saccincola	1677857	S	3	0	3	1244604	0.000002	0.000002
Faecalibacterium prausnitzii	853	S	3	0	3	1244604	0.000002	0.000002
Caproiciproducens sp. 7D4C2	2721621	S	2	0	2	1244604	0.000002	0.000002
Desulfitobacterium hafniense	49338	S	2	0	2	1244604	0.000002	0.000002
Intestinimonas butyriciproducens	1297617	S	2	0	2	1244604	0.000002	0.000002
Flintibacter sp. KGMB00164	2610895	S	2	0	2	1244604	0.000002	0.000002
Heliorestis convoluta	356322	S	2	0	2	1244604	0.000002	0.000002
Caldicellulosiruptor lactoaceticus	52766	S	1	1	2	1244604	0.000001	0.000002
Thermodesulfobium acidiphilum	1794699	S	2	0	2	1244604	0.000002	0.000002
Tepidanaerobacter acetatoxydans	499229	S	3	0	3	1244604	0.000002	0.000002
Thermosediminibacter oceani	291990	S	2	0	2	1244604	0.000002	0.000002
Veillonella parvula	29466	S	2	0	2	1244604	0.000002	0.000002
Veillonella dispar	39778	S	2	0	2	1244604	0.000002	0.000002
Acidaminococcus intestini	187327	S	3	0	3	1244604	0.000002	0.000002
[Clostridium] innocuum	1522	S	3	0	3	1244604	0.000002	0.000002
Erysipelatoclostridium ramosum	1547	S	3	0	3	1244604	0.000002	0.000002
Longibaculum sp. KGMB06250	2584943	S	1	1	2	1244604	0.000001	0.000002
Turicibacter sanguinis	154288	S	3	0	3	1244604	0.000002	0.000002
Turicibacter sp. H121	1712675	S	2	0	2	1244604	0.000002	0.000002
Finegoldia magna	1260	S	2	0	2	1244604	0.000002	0.000002
endosymbiont 'TC1' of Trimyema compressum	243899	S	3	0	3	1244604	0.000002	0.000002
Streptomyces sp. P3	2135430	S	3	0	3	1244604	0.000002	0.000002
Streptomyces sp. NA02950	2742137	S	3	0	3	1244604	0.000002	0.000002
Streptomyces sp. RLB1-33	2721243	S	3	0	3	1244604	0.000002	0.000002
Streptomyces sp. NEAU-sy36	2751189	S	3	0	3	1244604	0.000002	0.000002
Streptomyces sp. CRXT-Y-14	2768069	S	3	0	3	1244604	0.000002	0.000002
Streptomyces sp. INR7	2607753	S	3	0	3	1244604	0.000002	0.000002
Streptomyces sp. S063	2005885	S	3	0	3	1244604	0.000002	0.000002
Streptomyces sp. C8S0	2585716	S	3	0	3	1244604	0.000002	0.000002
Streptomyces sp. ID38640	1265399	S	2	0	2	1244604	0.000002	0.000002
Streptomyces sp. S4.7	2705439	S	2	0	2	1244604	0.000002	0.000002
Streptomyces sp. fd1-xmd	1812480	S	2	0	2	1244604	0.000002	0.000002
Streptomyces sp. NA04227	2742136	S	2	0	2	1244604	0.000002	0.000002
Streptomyces sp. NHF165	2175864	S	2	0	2	1244604	0.000002	0.000002
Streptomyces sp. 11-1-2	1851167	S	2	1	3	1244604	0.000002	0.000002
Streptomyces sp. NEAU-S7GS2	2202000	S	2	0	2	1244604	0.000002	0.000002
Streptomyces sp. 2323.1	1938841	S	2	0	2	1244604	0.000002	0.000002
Streptomyces sp. GF20	2692235	S	1	1	2	1244604	0.000001	0.000002
Streptomyces sp. 604F	1476754	S	1	1	2	1244604	0.000001	0.000002
Streptomyces roseochromogenus	285450	S	3	0	3	1244604	0.000002	0.000002
Streptomyces broussonetiae	2686304	S	3	0	3	1244604	0.000002	0.000002
Streptomyces spectabilis	68270	S	3	0	3	1244604	0.000002	0.000002
Streptomyces gilvosporeus	553510	S	3	0	3	1244604	0.000002	0.000002
Streptomyces lunaelactis	1535768	S	3	0	3	1244604	0.000002	0.000002
Streptomyces buecherae	2763006	S	2	0	2	1244604	0.000002	0.000002
Streptomyces alboniger	132473	S	2	0	2	1244604	0.000002	0.000002
Streptomyces cacaoi	1898	S	2	0	2	1244604	0.000002	0.000002
Streptomyces clavuligerus	1901	S	2	0	2	1244604	0.000002	0.000002
Streptomyces finlayi	67296	S	2	0	2	1244604	0.000002	0.000002
Streptomyces gardneri	66892	S	2	0	2	1244604	0.000002	0.000002
Streptomyces formicae	1616117	S	2	0	2	1244604	0.000002	0.000002
Streptomyces griseocarneus	51201	S	2	0	2	1244604	0.000002	0.000002
Streptomyces ficellus	1977088	S	2	0	2	1244604	0.000002	0.000002
Streptomyces rimosus	1927	S	2	0	2	1244604	0.000002	0.000002
Streptomyces tendae	1932	S	2	0	2	1244604	0.000002	0.000002
Streptomyces cyaneochromogenes	2496836	S	2	0	2	1244604	0.000002	0.000002
Streptomyces albidoflavus	1886	S	1	1	2	1244604	0.000001	0.000002
Streptacidiphilus sp. PB12-B1b	2705012	S	1	1	2	1244604	0.000001	0.000002
Kitasatospora setae	2066	S	3	0	3	1244604	0.000002	0.000002
Kitasatospora sp. MMS16-BH015	2018025	S	2	0	2	1244604	0.000002	0.000002
Mycobacterium mantenii	560555	S	2	0	2	1244604	0.000002	0.000002
Mycobacterium intracellulare	1767	S	1	2	3	1244604	0.000001	0.000002
Mycobacterium simiae	1784	S	2	0	2	1244604	0.000002	0.000002
Mycobacterium saskatchewanense	220927	S	2	0	2	1244604	0.000002	0.000002
Mycobacterium branderi	43348	S	2	0	2	1244604	0.000002	0.000002
Mycobacterium shinjukuense	398694	S	2	0	2	1244604	0.000002	0.000002
Mycobacterium conspicuum	44010	S	2	0	2	1244604	0.000002	0.000002
Mycobacterium haemophilum	29311	S	2	0	2	1244604	0.000002	0.000002
Mycobacterium gordonae	1778	S	2	0	2	1244604	0.000002	0.000002
Mycobacterium sp. WY10	1920667	S	1	1	2	1244604	0.000001	0.000002
Mycobacterium novum	2492438	S	1	1	2	1244604	0.000001	0.000002
Mycolicibacterium pulveris	36813	S	3	0	3	1244604	0.000002	0.000002
Mycolicibacterium duvalii	39688	S	2	0	2	1244604	0.000002	0.000002
Mycolicibacterium insubricum	444597	S	2	0	2	1244604	0.000002	0.000002
Mycolicibacterium rutilum	370526	S	2	0	2	1244604	0.000002	0.000002
Mycolicibacterium aubagnense	319707	S	2	0	2	1244604	0.000002	0.000002
Mycolicibacterium chubuense	1800	S	2	0	2	1244604	0.000002	0.000002
Mycolicibacterium fluoranthenivorans	258505	S	2	0	2	1244604	0.000002	0.000002
Mycolicibacterium doricum	126673	S	2	0	2	1244604	0.000002	0.000002
Mycolicibacterium boenickei	146017	S	1	1	2	1244604	0.000001	0.000002
Mycobacteroides immunogenum	83262	S	2	0	2	1244604	0.000002	0.000002
Rhodococcus sp. ABRD24	2507582	S	3	0	3	1244604	0.000002	0.000002
Rhodococcus opacus	37919	S	3	0	3	1244604	0.000002	0.000002
Nocardia asteroides	1824	S	3	0	3	1244604	0.000002	0.000002
Nocardia nova	37330	S	3	0	3	1244604	0.000002	0.000002
Nocardia sp. WCH-YHL-001	2755382	S	2	0	2	1244604	0.000002	0.000002
Corynebacterium maris	575200	S	3	0	3	1244604	0.000002	0.000002
Corynebacterium endometrii	2488819	S	3	0	3	1244604	0.000002	0.000002
Corynebacterium timonense	441500	S	3	0	3	1244604	0.000002	0.000002
Corynebacterium stationis	1705	S	2	0	2	1244604	0.000002	0.000002
Corynebacterium efficiens	152794	S	2	0	2	1244604	0.000002	0.000002
Corynebacterium glyciniphilum	1404244	S	2	0	2	1244604	0.000002	0.000002
Corynebacterium pseudotuberculosis	1719	S	2	0	2	1244604	0.000002	0.000002
Corynebacterium resistens	258224	S	1	1	2	1244604	0.000001	0.000002
Corynebacterium jeikeium	38289	S	1	2	3	1244604	0.000001	0.000002
Corynebacterium variabile	1727	S	1	1	2	1244604	0.000001	0.000002
Gordonia polyisoprenivorans	84595	S	2	0	2	1244604	0.000002	0.000002
Gordonia iterans	1004901	S	2	0	2	1244604	0.000002	0.000002
Tsukamurella paurometabola	2061	S	2	0	2	1244604	0.000002	0.000002
Tsukamurella tyrosinosolvens	57704	S	2	0	2	1244604	0.000002	0.000002
Dietzia timorensis	499555	S	2	0	2	1244604	0.000002	0.000002
Microbacterium wangchenii	2541726	S	3	0	3	1244604	0.000002	0.000002
Microbacterium aurum	36805	S	2	0	2	1244604	0.000002	0.000002
Microbacterium schleiferi	69362	S	1	1	2	1244604	0.000001	0.000002
Rathayibacter rathayi	33887	S	3	0	3	1244604	0.000002	0.000002
Rathayibacter sp. VKM Ac-2804	2609257	S	1	1	2	1244604	0.000001	0.000002
Agromyces protaetiae	2509455	S	3	0	3	1244604	0.000002	0.000002
Leifsonia xyli	1575	S	3	0	3	1244604	0.000002	0.000002
Frondihabitans sp. 762G35	1446794	S	2	0	2	1244604	0.000002	0.000002
Cnuibacter physcomitrellae	1619308	S	2	0	2	1244604	0.000002	0.000002
Gryllotalpicola protaetiae	2419771	S	2	0	2	1244604	0.000002	0.000002
Humibacter sp. WJ7-1	2599293	S	2	0	2	1244604	0.000002	0.000002
Arthrobacter sp. 24S4-2	2575374	S	3	0	3	1244604	0.000002	0.000002
Arthrobacter sp. D5-1	1477518	S	2	0	2	1244604	0.000002	0.000002
Arthrobacter sp. QXT-31	1357915	S	2	0	2	1244604	0.000002	0.000002
Arthrobacter sp. TES	2774874	S	1	2	3	1244604	0.000001	0.000002
Pseudarthrobacter sp. YJ56	2697569	S	2	0	2	1244604	0.000002	0.000002
Micrococcus luteus	1270	S	1	1	2	1244604	0.000001	0.000002
Sinomonas atrocyanea	37927	S	2	0	2	1244604	0.000002	0.000002
Glutamicibacter protophormiae	37930	S	1	1	2	1244604	0.000001	0.000002
Paenarthrobacter sp. YJN-5	2735316	S	1	1	2	1244604	0.000001	0.000002
Brevibacterium sp. WO024	2697563	S	1	1	2	1244604	0.000001	0.000002
Brevibacterium sp. PAMC23299	2762330	S	1	1	2	1244604	0.000001	0.000002
Brevibacterium luteolum	199591	S	1	2	3	1244604	0.000001	0.000002
Cellulomonas flavigena	1711	S	3	0	3	1244604	0.000002	0.000002
Cellulomonas shaoxiangyii	2566013	S	2	0	2	1244604	0.000002	0.000002
Pseudactinotalea sp. HY158	2654547	S	2	0	2	1244604	0.000002	0.000002
Ornithinimicrobium flavum	1288636	S	3	0	3	1244604	0.000002	0.000002
Ornithinimicrobium sp. HY006	2508882	S	2	0	2	1244604	0.000002	0.000002
Janibacter limosus	53458	S	2	0	2	1244604	0.000002	0.000002
Cellulosimicrobium sp. JZ28	1906273	S	3	0	3	1244604	0.000002	0.000002
Cellulosimicrobium cellulans	1710	S	2	0	2	1244604	0.000002	0.000002
Beutenbergia cavernae	84757	S	2	0	2	1244604	0.000002	0.000002
Georgenia faecalis	2483799	S	2	0	2	1244604	0.000002	0.000002
Haloactinobacterium sp. HY164	2675754	S	3	0	3	1244604	0.000002	0.000002
Dermabacter vaginalis	1630135	S	1	1	2	1244604	0.000001	0.000002
Kytococcus sedentarius	1276	S	2	0	2	1244604	0.000002	0.000002
Micromonospora sp. WMMC415	2675222	S	2	0	2	1244604	0.000002	0.000002
Micromonospora coxensis	356852	S	3	0	3	1244604	0.000002	0.000002
Micromonospora craniellae	2294034	S	2	0	2	1244604	0.000002	0.000002
Micromonospora auratinigra	261654	S	2	0	2	1244604	0.000002	0.000002
Micromonospora coriariae	285665	S	2	0	2	1244604	0.000002	0.000002
Actinoplanes missouriensis	1866	S	2	0	2	1244604	0.000002	0.000002
Actinoplanes derwentensis	113562	S	2	0	2	1244604	0.000002	0.000002
Plantactinospora sp. KBS50	2024580	S	3	0	3	1244604	0.000002	0.000002
Verrucosispora sp. NA02020	2742132	S	2	0	2	1244604	0.000002	0.000002
Salinispora tropica	168695	S	2	0	2	1244604	0.000002	0.000002
Actinocatenispora thailandica	227318	S	2	0	2	1244604	0.000002	0.000002
Nocardioides sp. JS614	196162	S	2	0	2	1244604	0.000002	0.000002
Nocardioides daphniae	402297	S	3	0	3	1244604	0.000002	0.000002
Nocardioides euryhalodurans	2518370	S	2	0	2	1244604	0.000002	0.000002
Aeromicrobium sp. A1-2	2107713	S	3	0	3	1244604	0.000002	0.000002
Aeromicrobium chenweiae	2079793	S	2	0	2	1244604	0.000002	0.000002
Marmoricola scoriae	642780	S	3	0	3	1244604	0.000002	0.000002
Tessaracoccus aquimaris	1332264	S	2	1	3	1244604	0.000002	0.000002
Tessaracoccus sp. MC1865	2760310	S	2	0	2	1244604	0.000002	0.000002
Amycolatopsis sp. AA4	1896961	S	2	0	2	1244604	0.000002	0.000002
Amycolatopsis methanolica	1814	S	2	0	2	1244604	0.000002	0.000002
Pseudonocardia dioxanivorans	240495	S	2	0	2	1244604	0.000002	0.000002
Saccharothrix sp. 6-C	2781735	S	3	0	3	1244604	0.000002	0.000002
Saccharothrix syringae	103733	S	2	0	2	1244604	0.000002	0.000002
Saccharomonospora cyanea	40989	S	1	1	2	1244604	0.000001	0.000002
Actinoalloteichus hymeniacidonis	340345	S	1	2	3	1244604	0.000001	0.000002
Kutzneria albida	43357	S	2	0	2	1244604	0.000002	0.000002
Allokutzneria albata	211114	S	2	0	2	1244604	0.000002	0.000002
Streptomonospora sp. M2	2498135	S	2	0	2	1244604	0.000002	0.000002
Actinomadura sp. WMMB 499	1219491	S	3	0	3	1244604	0.000002	0.000002
Actinomadura sp. WMMA1423	2591108	S	2	0	2	1244604	0.000002	0.000002
Actinomadura verrucosospora	46165	S	2	0	2	1244604	0.000002	0.000002
Actinomyces israelii	1659	S	3	0	3	1244604	0.000002	0.000002
Frankia inefficax	298654	S	2	0	2	1244604	0.000002	0.000002
Candidatus Frankia datiscae	2716812	S	2	0	2	1244604	0.000002	0.000002
Jiangella alkaliphila	419479	S	2	0	2	1244604	0.000002	0.000002
Nakamurella panacisegetis	1090615	S	3	0	3	1244604	0.000002	0.000002
Blastococcus saxobsidens	138336	S	3	0	3	1244604	0.000002	0.000002
Geodermatophilus obscurus	1861	S	2	0	2	1244604	0.000002	0.000002
Rubrobacter xylanophilus	49319	S	3	0	3	1244604	0.000002	0.000002
Slackia heliotrinireducens	84110	S	2	0	2	1244604	0.000002	0.000002
Conexibacter sp. SYSU D00693	2812560	S	3	0	3	1244604	0.000002	0.000002
Actinomarinicola tropica	2789776	S	2	0	2	1244604	0.000002	0.000002
Nostoc carneum	374162	S	2	0	2	1244604	0.000002	0.000002
Nostoc sphaeroides	446679	S	2	0	2	1244604	0.000002	0.000002
Calothrix parasitica	1973486	S	3	0	3	1244604	0.000002	0.000002
Scytonema sp. HK-05	1137095	S	2	0	2	1244604	0.000002	0.000002
Fischerella sp. NIES-3754	1752063	S	2	0	2	1244604	0.000002	0.000002
Synechococcus sp. HK01-R	2751171	S	2	0	2	1244604	0.000002	0.000002
Synechococcus sp. PCC 73109	374982	S	1	1	2	1244604	0.000001	0.000002
Leptolyngbya sp. BL0902	1115757	S	3	0	3	1244604	0.000002	0.000002
Gloeothece verrucosa	2546359	S	2	0	2	1244604	0.000002	0.000002
Candidatus Atelocyanobacterium thalassa	713887	S	2	0	2	1244604	0.000002	0.000002
Geminocystis sp. NIES-3708	1615909	S	2	0	2	1244604	0.000002	0.000002
Spiroplasma cantharicola	362837	S	3	0	3	1244604	0.000002	0.000002
Spiroplasma monobiae	2136	S	3	0	3	1244604	0.000002	0.000002
Mesoplasma chauliocola	216427	S	2	0	2	1244604	0.000002	0.000002
Mycoplasma sp. Zaradi2	547987	S	2	0	2	1244604	0.000002	0.000002
Mycoplasma sp. Pen4	640330	S	2	0	2	1244604	0.000002	0.000002
Mycoplasma dispar	86660	S	3	0	3	1244604	0.000002	0.000002
Mycoplasma iowae	2116	S	3	0	3	1244604	0.000002	0.000002
Mycoplasma putrefaciens	2123	S	2	0	2	1244604	0.000002	0.000002
Mycoplasma columborale	171282	S	3	0	3	1244604	0.000002	0.000002
Mycoplasma californicum	2113	S	3	0	3	1244604	0.000002	0.000002
Mycoplasma agalactiae	2110	S	2	0	2	1244604	0.000002	0.000002
Deinococcus sp. NW-56	2080419	S	3	0	3	1244604	0.000002	0.000002
Deinococcus geothermalis	68909	S	2	0	2	1244604	0.000002	0.000002
Deinococcus actinosclerus	1768108	S	2	0	2	1244604	0.000002	0.000002
Flavobacterium nitrogenifigens	1617283	S	2	0	2	1244604	0.000002	0.000002
Flavobacterium nackdongense	2547394	S	2	0	2	1244604	0.000002	0.000002
Flavobacterium commune	1306519	S	2	0	2	1244604	0.000002	0.000002
Flavobacterium indicum	312277	S	2	0	2	1244604	0.000002	0.000002
Tenacibaculum mesophilum	104268	S	3	0	3	1244604	0.000002	0.000002
Tenacibaculum dicentrarchi	669041	S	3	0	3	1244604	0.000002	0.000002
Tenacibaculum todarodis	1850252	S	3	0	3	1244604	0.000002	0.000002
Polaribacter reichenbachii	996801	S	2	0	2	1244604	0.000002	0.000002
Capnocytophaga cynodegmi	28189	S	3	0	3	1244604	0.000002	0.000002
Myroides profundi	480520	S	3	0	3	1244604	0.000002	0.000002
Myroides phaeus	702745	S	2	0	2	1244604	0.000002	0.000002
Aquimarina sp. TRL1	2736252	S	2	0	2	1244604	0.000002	0.000002
Maribacter sp. MJ134	2496865	S	3	0	3	1244604	0.000002	0.000002
Maribacter sp. T28	1836467	S	2	0	2	1244604	0.000002	0.000002
Winogradskyella sediminis	1382466	S	2	0	2	1244604	0.000002	0.000002
Lacinutrix venerupis	1486034	S	3	0	3	1244604	0.000002	0.000002
Psychroflexus sp. ALD_RP9	2777186	S	3	0	3	1244604	0.000002	0.000002
Costertonia aggregata	343403	S	2	0	2	1244604	0.000002	0.000002
Gramella salexigens	1913577	S	2	0	2	1244604	0.000002	0.000002
Dokdonia donghaensis	326320	S	2	0	2	1244604	0.000002	0.000002
Kordia sp. SMS9	2282170	S	2	0	2	1244604	0.000002	0.000002
Chryseobacterium sp. POL2	2713414	S	3	0	3	1244604	0.000002	0.000002
Chryseobacterium sp. G0186	2487064	S	2	0	2	1244604	0.000002	0.000002
Chryseobacterium sp. G0201	2487065	S	2	0	2	1244604	0.000002	0.000002
Chryseobacterium manosquense	2754694	S	2	1	3	1244604	0.000002	0.000002
Chryseobacterium aureum	2497456	S	2	0	2	1244604	0.000002	0.000002
Chryseobacterium gleum	250	S	2	0	2	1244604	0.000002	0.000002
Elizabethkingia anophelis	1117645	S	3	0	3	1244604	0.000002	0.000002
Elizabethkingia ursingii	1756150	S	2	0	2	1244604	0.000002	0.000002
Riemerella anatipestifer	34085	S	2	0	2	1244604	0.000002	0.000002
Blattabacterium sp. (Cryptocercus kyebangensis)	298656	S	2	0	2	1244604	0.000002	0.000002
Candidatus Sulcia muelleri	336810	S	2	0	2	1244604	0.000002	0.000002
Hymenobacter sp. APR13	1356852	S	2	0	2	1244604	0.000002	0.000002
Hymenobacter nivis	1850093	S	2	0	2	1244604	0.000002	0.000002
Hymenobacter russus	2724192	S	2	0	2	1244604	0.000002	0.000002
Echinicola sp. LN3S3	2591634	S	2	0	2	1244604	0.000002	0.000002
Belliella baltica	232259	S	2	0	2	1244604	0.000002	0.000002
Spirosoma sp. KCTC 42546	2520506	S	2	0	2	1244604	0.000002	0.000002
Spirosoma pollinicola	2057025	S	2	0	2	1244604	0.000002	0.000002
Runella sp. HYN0085	2259595	S	3	0	3	1244604	0.000002	0.000002
Arcticibacterium luteifluviistationis	1784714	S	2	0	2	1244604	0.000002	0.000002
Sphingobacterium sp. DR205	2713573	S	3	0	3	1244604	0.000002	0.000002
Sphingobacterium sp. UDSM-2020	2795738	S	2	0	2	1244604	0.000002	0.000002
Sphingobacterium sp. G1-14	2003121	S	1	2	3	1244604	0.000001	0.000002
Mucilaginibacter paludis	423351	S	2	0	2	1244604	0.000002	0.000002
Pedobacter sp. CJ43	2605747	S	3	0	3	1244604	0.000002	0.000002
Pedobacter sp. SW-16	2766984	S	2	0	2	1244604	0.000002	0.000002
Bacteroides caecimuris	1796613	S	2	0	2	1244604	0.000002	0.000002
Prevotella intermedia	28131	S	2	0	2	1244604	0.000002	0.000002
Prevotella sp. WR041	2801997	S	2	0	2	1244604	0.000002	0.000002
Parabacteroides distasonis	823	S	1	1	2	1244604	0.000001	0.000002
Muribaculum intestinale	1796646	S	3	0	3	1244604	0.000002	0.000002
Draconibacterium orientale	1168034	S	3	0	3	1244604	0.000002	0.000002
Flavisolibacter tropicus	1492898	S	2	0	2	1244604	0.000002	0.000002
Niastella koreensis	354356	S	2	0	2	1244604	0.000002	0.000002
Niabella ginsenosidivorans	1176587	S	2	0	2	1244604	0.000002	0.000002
Chlorobium phaeovibrioides	1094	S	2	0	2	1244604	0.000002	0.000002
Gemmatimonas phototrophica	1379270	S	3	0	3	1244604	0.000002	0.000002
Gemmatimonas sp. TET16	2732249	S	3	0	3	1244604	0.000002	0.000002
Gemmatimonas aurantiaca	173480	S	2	0	2	1244604	0.000002	0.000002
Lacipirellula parvula	2650471	S	2	0	2	1244604	0.000002	0.000002
Isosphaera pallida	128	S	3	0	3	1244604	0.000002	0.000002
Aquisphaera giovannonii	406548	S	3	0	3	1244604	0.000002	0.000002
Tautonia plasticadhaerens	2527974	S	3	0	3	1244604	0.000002	0.000002
Akkermansia muciniphila	239935	S	3	0	3	1244604	0.000002	0.000002
Opitutus sp. GAS368	1882749	S	2	0	2	1244604	0.000002	0.000002
Treponema caldarium	215591	S	2	0	2	1244604	0.000002	0.000002
Thiospirochaeta perfilievii	252967	S	2	0	2	1244604	0.000002	0.000002
Borrelia coriaceae	144	S	3	0	3	1244604	0.000002	0.000002
Borrelia miyamotoi	47466	S	3	0	3	1244604	0.000002	0.000002
Borreliella garinii	29519	S	3	0	3	1244604	0.000002	0.000002
Leptospira tipperaryensis	2564040	S	2	0	2	1244604	0.000002	0.000002
Fusobacterium necrophorum	859	S	2	0	2	1244604	0.000002	0.000002
Leptotrichia sp. oral taxon 847	1785996	S	3	0	3	1244604	0.000002	0.000002
Leptotrichia buccalis	40542	S	2	0	2	1244604	0.000002	0.000002
Sebaldella termitidis	826	S	3	0	3	1244604	0.000002	0.000002
Terriglobus roseus	392734	S	2	0	2	1244604	0.000002	0.000002
Terriglobus saanensis	870903	S	2	0	2	1244604	0.000002	0.000002
Thermosipho sp. FR-w03	2814656	S	3	0	3	1244604	0.000002	0.000002
Fervidobacterium nodosum	2424	S	1	1	2	1244604	0.000001	0.000002
Caldithrix abyssi	187145	S	3	0	3	1244604	0.000002	0.000002
Dictyoglomus thermophilum	14	S	2	0	2	1244604	0.000002	0.000002
Haloferax gibbonsii	35746	S	3	0	3	1244604	0.000002	0.000002
Haloarcula marismortui	2238	S	1	1	2	1244604	0.000001	0.000002
Natronomonas sp. YPL13	1710540	S	2	0	2	1244604	0.000002	0.000002
Methanosarcina barkeri	2208	S	2	0	2	1244604	0.000002	0.000002
Methanomethylovorans hollandica	101192	S	2	0	2	1244604	0.000002	0.000002
Methanospirillum hungatei	2203	S	2	0	2	1244604	0.000002	0.000002
Methanocella arvoryzae	1175445	S	3	0	3	1244604	0.000002	0.000002
Methanocaldococcus infernus	67760	S	2	0	2	1244604	0.000002	0.000002
Thermococcus sp. AM4	246969	S	2	0	2	1244604	0.000002	0.000002
Thermococcus chitonophagus	54262	S	2	0	2	1244604	0.000002	0.000002
Acidianus hospitalis	563177	S	3	0	3	1244604	0.000002	0.000002
Staphylothermus marinus	2280	S	2	0	2	1244604	0.000002	0.000002
Candidatus Nitrosotalea okcheonensis	1903276	S	2	0	2	1244604	0.000002	0.000002
Nitrosopumilus cobalaminigenes	1470066	S	2	0	2	1244604	0.000002	0.000002
Nitrosopumilus piranensis	1582439	S	2	0	2	1244604	0.000002	0.000002
Candidatus Nitrosocosmicus hydrocola	1826872	S	2	0	2	1244604	0.000002	0.000002
Proteus phage vB_PmiM_Pm5461	1636250	S	2	0	2	1244604	0.000002	0.000002
Aeromonas phage AS-sw	2026113	S	1	1	2	1244604	0.000001	0.000002
Escherichia virus VR5	1914195	S	2	0	2	1244604	0.000002	0.000002
Escherichia virus VR7	1913683	S	1	2	3	1244604	0.000001	0.000002
Salmonella virus SSE121	1914893	S	2	1	3	1244604	0.000002	0.000002
Pseudomonas phage Persinger	2749430	S	2	0	2	1244604	0.000002	0.000002
Escherichia phage vB_EcoM_PHB05	2041347	S	1	1	2	1244604	0.000001	0.000002
Salmonella virus SJ2	1987158	S	1	2	3	1244604	0.000001	0.000002
Salmonella virus ViI	1987993	S	1	2	3	1244604	0.000001	0.000002
Escherichia virus phAPEC8	2734131	S	1	1	2	1244604	0.000001	0.000002
Vibrio phage USC-1	2592615	S	2	0	2	1244604	0.000002	0.000002
Acinetobacter virus ME3	2560269	S	3	0	3	1244604	0.000002	0.000002
Pseudomonas virus EL	1984787	S	2	0	2	1244604	0.000002	0.000002
Erwinia virus Risingsun	2560435	S	2	0	2	1244604	0.000002	0.000002
Cronobacter phage CR5	1195085	S	2	0	2	1244604	0.000002	0.000002
Prochlorococcus virus PSSM7	2734127	S	2	0	2	1244604	0.000002	0.000002
Pseudomonas phage PhiPA3	998086	S	2	0	2	1244604	0.000002	0.000002
Escherichia virus P483	2732779	S	2	1	3	1244604	0.000002	0.000002
Yersinia virus AP10	2732775	S	2	0	2	1244604	0.000002	0.000002
Proteus virus PM16	2733609	S	3	0	3	1244604	0.000002	0.000002
Escherichia virus LL11	2744412	S	3	0	3	1244604	0.000002	0.000002
Erwinia virus S2	2733579	S	3	0	3	1244604	0.000002	0.000002
Escherichia virus ECBP5	2733916	S	2	0	2	1244604	0.000002	0.000002
Escherichia virus PGT2	2733903	S	2	0	2	1244604	0.000002	0.000002
Cronobacter phage ENT47670	984186	S	3	0	3	1244604	0.000002	0.000002
Escherichia phage HK639	906669	S	3	0	3	1244604	0.000002	0.000002
Salmonella phage 118970_sal1	1813781	S	2	1	3	1244604	0.000002	0.000002
Serratia phage KpYy_1_41	2698927	S	2	1	3	1244604	0.000002	0.000002
Salmonella phage Season12	2500556	S	2	1	3	1244604	0.000002	0.000002
Escherichia phage Utah	1916098	S	1	2	3	1244604	0.000001	0.000002
Salmonella phage vB_SalS_ABTNLsp1	2789810	S	1	1	2	1244604	0.000001	0.000002
Salmonella phage KFS-SE1	2048975	S	1	1	2	1244604	0.000001	0.000002
Salmonella phage BSPM4	1958913	S	1	1	2	1244604	0.000001	0.000002
Enterobacter phage KNP7	1871712	S	1	1	2	1244604	0.000001	0.000002
Salmonella virus FSLSP088	1173757	S	2	0	2	1244604	0.000002	0.000002
Salmonella virus YSD1	2749260	S	2	1	3	1244604	0.000002	0.000002
Proteus virus Isfahan	2560650	S	3	0	3	1244604	0.000002	0.000002
Escherichia phage slur05	1720498	S	1	1	2	1244604	0.000001	0.000002
Mycobacterium virus Bron	861047	S	2	0	2	1244604	0.000002	0.000002
Salmonella phage BSP101	1958914	S	1	2	3	1244604	0.000001	0.000002
Salmonella phage SenASZ3	2301648	S	1	2	3	1244604	0.000001	0.000002
Escherichia phage EP75	2070200	S	1	1	2	1244604	0.000001	0.000002
Salmonella phage Mutine	2054274	S	1	1	2	1244604	0.000001	0.000002
Salmonella virus 38	2169807	S	2	0	2	1244604	0.000002	0.000002
Serratia phage vB_SmaA_3M	2419930	S	3	0	3	1244604	0.000002	0.000002
Erwinia phage vB_EamM-Bue1	2099338	S	2	1	3	1244604	0.000002	0.000002
Klebsiella phage KP8	2099850	S	2	0	2	1244604	0.000002	0.000002
Escherichia virus Pollock	2170215	S	2	0	2	1244604	0.000002	0.000002
Klebsiella phage vB_KpnS_Call	2591371	S	1	1	2	1244604	0.000001	0.000002
Salmonella phage Sepoy	2565517	S	1	1	2	1244604	0.000001	0.000002
Salmonella phage OSY-STA	2596884	S	1	2	3	1244604	0.000001	0.000002
Salmonella virus S126	2732028	S	1	1	2	1244604	0.000001	0.000002
Salmonella virus Sw2	2732035	S	1	1	2	1244604	0.000001	0.000002
Salmonella virus 123	2732021	S	1	1	2	1244604	0.000001	0.000002
Escherichia phage vB_EcoS_HdH2	2508174	S	2	0	2	1244604	0.000002	0.000002
Salmonella virus SP01	2733990	S	2	0	2	1244604	0.000002	0.000002
Pectobacterium virus My1	2560631	S	1	1	2	1244604	0.000001	0.000002
Canarypox virus	44088	S	2	0	2	1244604	0.000002	0.000002
Nile crocodilepox virus	1285600	S	2	0	2	1244604	0.000002	0.000002
Megavirus chiliensis	1094892	S	2	0	2	1244604	0.000002	0.000002
Beihai picorna-like virus 113	1922542	S	2	0	2	1244604	0.000002	0.000002
Hubei picorna-like virus 80	1923165	S	2	0	2	1244604	0.000002	0.000002
Perigonia lusca nucleopolyhedrovirus	2560642	S	2	0	2	1244604	0.000002	0.000002
Neodiprion sertifer nucleopolyhedrovirus	111874	S	3	0	3	1244604	0.000002	0.000002
Salmonella virus IKe	1977304	S	2	0	2	1244604	0.000002	0.000002
Heliothis zea nudivirus	29250	S	2	0	2	1244604	0.000002	0.000002
Blochmannia endosymbiont of Colobopsis nipponica	2681987	S	1	0	1	1244604	0.000001	0.000001
secondary endosymbiont of Trabutina mannipara	1835721	S	1	0	1	1244604	0.000001	0.000001
Candidatus Tachikawaea gelatinosa	1410383	S	1	0	1	1244604	0.000001	0.000001
Candidatus Mikella endobia	1778264	S	1	0	1	1244604	0.000001	0.000001
Enterobacteriaceae endosymbiont of Donacia sparganii	2675785	S	1	0	1	1244604	0.000001	0.000001
Enterobacteriaceae endosymbiont of Plateumaris sericea	2675797	S	1	0	1	1244604	0.000001	0.000001
Enterobacteriaceae endosymbiont of Neohaemonia nigricornis	2675792	S	1	0	1	1244604	0.000001	0.000001
Candidatus Ishikawaella capsulata	168169	S	1	0	1	1244604	0.000001	0.000001
Arsenophonus endosymbiont of Aleurodicus dispersus	235559	S	1	0	1	1244604	0.000001	0.000001
Rahnella sp. WMR114	657335	S	1	0	1	1244604	0.000001	0.000001
Sodalis endosymbiont of Henestaris halophilus	1929246	S	1	0	1	1244604	0.000001	0.000001
Entomomonas sp. F2A	2785331	S	1	0	1	1244604	0.000001	0.000001
Acinetobacter sp. LoGeW2-3	1808001	S	1	0	1	1244604	0.000001	0.000001
Acinetobacter sp. NEB149	2725684	S	1	0	1	1244604	0.000001	0.000001
Acinetobacter sp. WCHA45	2004644	S	1	0	1	1244604	0.000001	0.000001
Acinetobacter tandoii	202954	S	1	0	1	1244604	0.000001	0.000001
Acinetobacter defluvii	1871111	S	1	0	1	1244604	0.000001	0.000001
Acinetobacter cumulans	2136182	S	1	0	1	1244604	0.000001	0.000001
Acinetobacter larvae	1789224	S	1	0	1	1244604	0.000001	0.000001
Acinetobacter venetianus	52133	S	1	0	1	1244604	0.000001	0.000001
Psychrobacter sp. PRwf-1	349106	S	1	0	1	1244604	0.000001	0.000001
Psychrobacter sp. DAB_AL43B	1028416	S	1	0	1	1244604	0.000001	0.000001
Psychrobacter sp. AntiMn-1	1720344	S	1	0	1	1244604	0.000001	0.000001
Psychrobacter urativorans	45610	S	1	0	1	1244604	0.000001	0.000001
Moraxella bovis	476	S	1	0	1	1244604	0.000001	0.000001
Moraxella nonliquefaciens	478	S	1	0	1	1244604	0.000001	0.000001
Moraxella cuniculi	34061	S	1	0	1	1244604	0.000001	0.000001
Moraxella bovoculi	386891	S	1	0	1	1244604	0.000001	0.000001
Tolumonas auensis	43948	S	1	0	1	1244604	0.000001	0.000001
Dongshaea marina	2047966	S	1	0	1	1244604	0.000001	0.000001
Shewanella sp. MEBiC00475	2575361	S	1	0	1	1244604	0.000001	0.000001
Shewanella sp. Pdp11	2059264	S	1	0	1	1244604	0.000001	0.000001
Shewanella sp. FJAT-53720	2814292	S	1	0	1	1244604	0.000001	0.000001
Shewanella sp. FJAT-52962	2814293	S	1	0	1	1244604	0.000001	0.000001
Shewanella sp. FJAT-53726	2814295	S	1	0	1	1244604	0.000001	0.000001
Shewanella psychrophila	225848	S	1	0	1	1244604	0.000001	0.000001
Shewanella marisflavi	260364	S	1	0	1	1244604	0.000001	0.000001
Shewanella woodyi	60961	S	1	0	1	1244604	0.000001	0.000001
Shewanella loihica	359303	S	1	0	1	1244604	0.000001	0.000001
Shewanella violacea	60217	S	1	0	1	1244604	0.000001	0.000001
Shewanella frigidimarina	56812	S	1	0	1	1244604	0.000001	0.000001
Shewanella khirikhana	1965282	S	1	0	1	1244604	0.000001	0.000001
Marinobacter sp. BSs20148	490759	S	1	0	1	1244604	0.000001	0.000001
Marinobacter sp. NP-4(2019)	2488665	S	1	0	1	1244604	0.000001	0.000001
Alteromonas australica	589873	S	1	0	1	1244604	0.000001	0.000001
Alteromonas pelagimontana	1858656	S	1	0	1	1244604	0.000001	0.000001
Catenovulum sp. CCB-QB4	2172099	S	1	0	1	1244604	0.000001	0.000001
Paraglaciecola sp. L1A13	2686359	S	1	0	1	1244604	0.000001	0.000001
Salinimonas sp. KX18D6	2572577	S	1	0	1	1244604	0.000001	0.000001
Glaciecola nitratireducens	300231	S	1	0	1	1244604	0.000001	0.000001
Lacimicrobium alkaliphilum	1526571	S	1	0	1	1244604	0.000001	0.000001
Pseudoalteromonas sp. SM1988	2744479	S	1	0	1	1244604	0.000001	0.000001
Pseudoalteromonas sp. NC201	1514074	S	1	0	1	1244604	0.000001	0.000001
Pseudoalteromonas sp. THAF3	2587843	S	1	0	1	1244604	0.000001	0.000001
Pseudoalteromonas piratica	1348114	S	1	0	1	1244604	0.000001	0.000001
Pseudoalteromonas aliena	247523	S	1	0	1	1244604	0.000001	0.000001
Pseudoalteromonas viridis	339617	S	1	0	1	1244604	0.000001	0.000001
Pseudoalteromonas luteoviolacea	43657	S	1	0	1	1244604	0.000001	0.000001
Pseudoalteromonas shioyasakiensis	1190813	S	1	0	1	1244604	0.000001	0.000001
Pseudoalteromonas espejiana	28107	S	1	0	1	1244604	0.000001	0.000001
Psychrosphaera sp. MTZ26	2820710	S	1	0	1	1244604	0.000001	0.000001
Colwellia sp. MT41	58049	S	1	0	1	1244604	0.000001	0.000001
Colwellia sp. PAMC 20917	1816218	S	1	0	1	1244604	0.000001	0.000001
Colwellia sp. Arc7-635	2497879	S	1	0	1	1244604	0.000001	0.000001
Colwellia beringensis	1967665	S	1	0	1	1244604	0.000001	0.000001
Thalassotalea sp. HSM 43	2552945	S	1	0	1	1244604	0.000001	0.000001
Ferrimonas lipolytica	2724191	S	1	0	1	1244604	0.000001	0.000001
Idiomarina sp. X4	2055892	S	1	0	1	1244604	0.000001	0.000001
Vibrio antiquarius	150340	S	1	0	1	1244604	0.000001	0.000001
Vibrio harveyi	669	S	1	0	1	1244604	0.000001	0.000001
Vibrio owensii	696485	S	1	0	1	1244604	0.000001	0.000001
Vibrio sp. 23023	452803	S	1	0	1	1244604	0.000001	0.000001
Vibrio sp. ZWAL4003	2711221	S	1	0	1	1244604	0.000001	0.000001
Vibrio sp. Scap24	2589990	S	1	0	1	1244604	0.000001	0.000001
Vibrio tritonius	1435069	S	1	0	1	1244604	0.000001	0.000001
Vibrio qinghaiensis	2025808	S	1	0	1	1244604	0.000001	0.000001
Vibrio aphrogenes	1891186	S	1	0	1	1244604	0.000001	0.000001
Vibrio kanaloae	170673	S	1	0	1	1244604	0.000001	0.000001
Vibrio panuliri	1381081	S	1	0	1	1244604	0.000001	0.000001
Vibrio alfacsensis	1074311	S	1	0	1	1244604	0.000001	0.000001
Vibrio casei	673372	S	1	0	1	1244604	0.000001	0.000001
Vibrio tapetis	52443	S	1	0	1	1244604	0.000001	0.000001
Vibrio ponticus	265668	S	1	0	1	1244604	0.000001	0.000001
Salinivibrio kushneri	1908198	S	1	0	1	1244604	0.000001	0.000001
Candidatus Enterovibrio luxaltus	1927128	S	1	0	1	1244604	0.000001	0.000001
Paraphotobacterium marinum	1755811	S	1	0	1	1244604	0.000001	0.000001
Stenotrophomonas sp. ZAC14D2_NAIMI4_7	2072405	S	1	0	1	1244604	0.000001	0.000001
Stenotrophomonas sp. ZAC14D2_NAIMI4_6	2072406	S	1	0	1	1244604	0.000001	0.000001
Stenotrophomonas sp. WZN-1	2005046	S	1	0	1	1244604	0.000001	0.000001
Stenotrophomonas sp. Pemsol	2040586	S	1	0	1	1244604	0.000001	0.000001
Stenotrophomonas sp. 169	2770322	S	1	0	1	1244604	0.000001	0.000001
Xanthomonas sp. GW	2724121	S	1	0	1	1244604	0.000001	0.000001
Xanthomonas sp. SS	2724122	S	1	0	1	1244604	0.000001	0.000001
Xanthomonas sp. LMG 31887	2775162	S	1	0	1	1244604	0.000001	0.000001
Xanthomonas cucurbitae	56453	S	1	0	1	1244604	0.000001	0.000001
Xanthomonas arboricola	56448	S	1	0	1	1244604	0.000001	0.000001
Xanthomonas fragariae	48664	S	1	0	1	1244604	0.000001	0.000001
Lysobacter sp. H21R20	2781022	S	1	0	1	1244604	0.000001	0.000001
Lysobacter gummosus	262324	S	1	0	1	1244604	0.000001	0.000001
Lysobacter lycopersici	1324796	S	1	0	1	1244604	0.000001	0.000001
Thermomonas sp. HDW16	2714945	S	1	0	1	1244604	0.000001	0.000001
Luteimonas sp. MC1825	2761107	S	1	0	1	1244604	0.000001	0.000001
Luteimonas granuli	1176533	S	1	0	1	1244604	0.000001	0.000001
Luteimonas yindakuii	2565782	S	1	0	1	1244604	0.000001	0.000001
Pseudoxanthomonas mexicana	128785	S	1	0	1	1244604	0.000001	0.000001
Pseudolysobacter antarcticus	2511995	S	1	0	1	1244604	0.000001	0.000001
Dyella japonica	231455	S	1	0	1	1244604	0.000001	0.000001
Rhodanobacter sp. FDAARGOS 1247	2778082	S	1	0	1	1244604	0.000001	0.000001
Dokdonella koreensis	323415	S	1	0	1	1244604	0.000001	0.000001
Halomonas sp. 1513	1883416	S	1	0	1	1244604	0.000001	0.000001
Halomonas sp. SH5A2	2749040	S	1	0	1	1244604	0.000001	0.000001
Halomonas sp. N3-2A	2014541	S	1	0	1	1244604	0.000001	0.000001
Halomonas sp. JS92-SW72	2306583	S	1	0	1	1244604	0.000001	0.000001
Halomonas sp. THAF12	2587849	S	1	0	1	1244604	0.000001	0.000001
Halomonas beimenensis	475662	S	1	0	1	1244604	0.000001	0.000001
Halomonas venusta	44935	S	1	0	1	1244604	0.000001	0.000001
Kushneria phosphatilytica	657387	S	1	0	1	1244604	0.000001	0.000001
Zymobacter palmae	33074	S	1	0	1	1244604	0.000001	0.000001
Pistricoccus aurantiacus	1883414	S	1	0	1	1244604	0.000001	0.000001
Marinomonas posidonica	936476	S	1	0	1	1244604	0.000001	0.000001
Neptunomonas japonica	417574	S	1	0	1	1244604	0.000001	0.000001
Neptunomonas concharum	1031538	S	1	0	1	1244604	0.000001	0.000001
Marinobacterium georgiense	48076	S	1	0	1	1244604	0.000001	0.000001
Marinobacterium aestuarii	1821621	S	1	0	1	1244604	0.000001	0.000001
Marinobacterium sp. LSUCC0821	2668067	S	1	0	1	1244604	0.000001	0.000001
Amphritea japonica	452627	S	1	0	1	1244604	0.000001	0.000001
Alcanivorax dieselolei	285091	S	1	0	1	1244604	0.000001	0.000001
Alcanivorax xenomutans	1094342	S	1	0	1	1244604	0.000001	0.000001
Gynuella sunshinyii	1445505	S	1	0	1	1244604	0.000001	0.000001
Hahella chejuensis	158327	S	1	0	1	1244604	0.000001	0.000001
Hahella sp. KA22	1628392	S	1	0	1	1244604	0.000001	0.000001
Spartinivicinus ruber	2683272	S	1	0	1	1244604	0.000001	0.000001
Kangiella geojedonensis	914150	S	1	0	1	1244604	0.000001	0.000001
Kangiella profundi	1561924	S	1	0	1	1244604	0.000001	0.000001
Haemophilus haemolyticus	726	S	1	0	1	1244604	0.000001	0.000001
[Haemophilus] ducreyi	730	S	1	0	1	1244604	0.000001	0.000001
Haemophilus parahaemolyticus	735	S	1	0	1	1244604	0.000001	0.000001
Haemophilus sp. oral taxon 036	712310	S	1	0	1	1244604	0.000001	0.000001
Mannheimia granulomatis	85402	S	1	0	1	1244604	0.000001	0.000001
Aggregatibacter segnis	739	S	1	0	1	1244604	0.000001	0.000001
Bisgaardia hudsonensis	109472	S	1	0	1	1244604	0.000001	0.000001
Gallibacterium anatis	750	S	1	0	1	1244604	0.000001	0.000001
Basfia succiniciproducens	653940	S	1	0	1	1244604	0.000001	0.000001
Hydrogenovibrio marinus	28885	S	1	0	1	1244604	0.000001	0.000001
Hydrogenovibrio thermophilus	265883	S	1	0	1	1244604	0.000001	0.000001
Francisella sp. LA112445	1395624	S	1	0	1	1244604	0.000001	0.000001
Francisella tularensis	263	S	1	0	1	1244604	0.000001	0.000001
Thiocystis violascens	73141	S	1	0	1	1244604	0.000001	0.000001
Allochromatium vinosum	1049	S	1	0	1	1244604	0.000001	0.000001
Marichromatium purpuratum	37487	S	1	0	1	1244604	0.000001	0.000001
Thioalkalivibrio versutus	106634	S	1	0	1	1244604	0.000001	0.000001
Thioalkalivibrio nitratireducens	186931	S	1	0	1	1244604	0.000001	0.000001
Spiribacter curvatus	1335757	S	1	0	1	1244604	0.000001	0.000001
Ectothiorhodospira haloalkaliphila	421628	S	1	0	1	1244604	0.000001	0.000001
Ectothiorhodospira sp. BSL-9	1442136	S	1	0	1	1244604	0.000001	0.000001
Wenzhouxiangella marina	1579979	S	1	0	1	1244604	0.000001	0.000001
Wenzhouxiangella sp. AB-CW3	2771012	S	1	0	1	1244604	0.000001	0.000001
Woeseia oceani	1548547	S	1	0	1	1244604	0.000001	0.000001
Teredinibacter purpureus	2731756	S	1	0	1	1244604	0.000001	0.000001
Saccharophagus degradans	86304	S	1	0	1	1244604	0.000001	0.000001
Microbulbifer sp. A4B17	359370	S	1	0	1	1244604	0.000001	0.000001
Microbulbifer sp. THAF38	2587856	S	1	0	1	1244604	0.000001	0.000001
Microbulbifer sp. GL-2	2591606	S	1	0	1	1244604	0.000001	0.000001
Microbulbifer hydrolyticus	48074	S	1	0	1	1244604	0.000001	0.000001
Microbulbifer thermotolerans	252514	S	1	0	1	1244604	0.000001	0.000001
Legionella sp. MW5194	2662448	S	1	0	1	1244604	0.000001	0.000001
Legionella waltersii	66969	S	1	0	1	1244604	0.000001	0.000001
Legionella longbeachae	450	S	1	0	1	1244604	0.000001	0.000001
Aquicella lusitana	254246	S	1	0	1	1244604	0.000001	0.000001
Methylomonas sp. DH-1	1727196	S	1	0	1	1244604	0.000001	0.000001
Methylomonas koyamae	702114	S	1	0	1	1244604	0.000001	0.000001
Methylomonas rhizoryzae	2608981	S	1	0	1	1244604	0.000001	0.000001
Methylocaldum marinum	1432792	S	1	0	1	1244604	0.000001	0.000001
Candidatus Thioglobus autotrophicus	1705394	S	1	0	1	1244604	0.000001	0.000001
endosymbiont of Sipalinus gigas	1972134	S	1	0	1	1244604	0.000001	0.000001
Thiolapillus brandeum	1076588	S	1	0	1	1244604	0.000001	0.000001
endosymbiont of unidentified scaly snail isolate Monju	1248727	S	1	0	1	1244604	0.000001	0.000001
Salinisphaera sp. LB1	2183911	S	1	0	1	1244604	0.000001	0.000001
Immundisolibacter cernigliae	1810504	S	1	0	1	1244604	0.000001	0.000001
Variovorax sp. RA8	662548	S	1	0	1	1244604	0.000001	0.000001
Variovorax sp. PAMC28562	2762323	S	1	0	1	1244604	0.000001	0.000001
Limnohabitans sp. 103DPR2	1678129	S	1	0	1	1244604	0.000001	0.000001
Candidatus Symbiobacter mobilis	1436290	S	1	0	1	1244604	0.000001	0.000001
Paraburkholderia terrae	311230	S	1	0	1	1244604	0.000001	0.000001
Paraburkholderia caledonica	134536	S	1	0	1	1244604	0.000001	0.000001
Paraburkholderia graminis	60548	S	1	0	1	1244604	0.000001	0.000001
Pandoraea vervacti	656178	S	1	0	1	1244604	0.000001	0.000001
Polynucleobacter necessarius	576610	S	1	0	1	1244604	0.000001	0.000001
Polynucleobacter paneuropaeus	2527775	S	1	0	1	1244604	0.000001	0.000001
Mycoavidus cysteinexigens	1553431	S	1	0	1	1244604	0.000001	0.000001
Mycetohabitans rhizoxinica	412963	S	1	0	1	1244604	0.000001	0.000001
Ephemeroptericola cinctiostellae	2268024	S	1	0	1	1244604	0.000001	0.000001
Bordetella holmesii	35814	S	1	0	1	1244604	0.000001	0.000001
Alcaligenes aquatilis	323284	S	1	0	1	1244604	0.000001	0.000001
Oligella urethralis	90245	S	1	0	1	1244604	0.000001	0.000001
Advenella kashmirensis	310575	S	1	0	1	1244604	0.000001	0.000001
Pusillimonas thiosulfatoxidans	2028345	S	1	0	1	1244604	0.000001	0.000001
Massilia plicata	321984	S	1	0	1	1244604	0.000001	0.000001
Janthinobacterium sp. 1_2014MBL_MicDiv	1644131	S	1	0	1	1244604	0.000001	0.000001
Janthinobacterium svalbardensis	368607	S	1	0	1	1244604	0.000001	0.000001
Thiomonas intermedia	926	S	1	0	1	1244604	0.000001	0.000001
Inhella inkyongensis	392593	S	1	0	1	1244604	0.000001	0.000001
Chromobacterium phragmitis	2202141	S	1	0	1	1244604	0.000001	0.000001
Aquitalea denitrificans	519081	S	1	0	1	1244604	0.000001	0.000001
Jeongeupia sp. HS-3	1009682	S	1	0	1	1244604	0.000001	0.000001
Chitinibacter fontanus	1737446	S	1	0	1	1244604	0.000001	0.000001
Neisseria sp. oral taxon 014	641148	S	1	0	1	1244604	0.000001	0.000001
Neisseria subflava	28449	S	1	0	1	1244604	0.000001	0.000001
Neisseria brasiliensis	2666100	S	1	0	1	1244604	0.000001	0.000001
Neisseria zoodegmatis	326523	S	1	0	1	1244604	0.000001	0.000001
Neisseria gonorrhoeae	485	S	1	0	1	1244604	0.000001	0.000001
Kingella kingae	504	S	1	0	1	1244604	0.000001	0.000001
Snodgrassella alvi	1196083	S	1	0	1	1244604	0.000001	0.000001
Thauera aromatica	59405	S	1	0	1	1244604	0.000001	0.000001
Thauera chlorobenzoica	96773	S	1	0	1	1244604	0.000001	0.000001
Azoarcus sp. KH32C	748247	S	1	0	1	1244604	0.000001	0.000001
Azoarcus sp. M9-3-2	2016596	S	1	0	1	1244604	0.000001	0.000001
Azoarcus olearius	418699	S	1	0	1	1244604	0.000001	0.000001
Sulfuritalea hydrogenivorans	748811	S	1	0	1	1244604	0.000001	0.000001
Nitrosomonas communis	44574	S	1	0	1	1244604	0.000001	0.000001
Nitrosomonas stercoris	1444684	S	1	0	1	1244604	0.000001	0.000001
Candidatus Nitrotoga sp. AM1P	2559597	S	1	0	1	1244604	0.000001	0.000001
Ferriphaselus amnicola	1188319	S	1	0	1	1244604	0.000001	0.000001
Methylotenera mobilis	359408	S	1	0	1	1244604	0.000001	0.000001
Methylotenera versatilis	1055487	S	1	0	1	1244604	0.000001	0.000001
Sulfuriferula nivalis	2675298	S	1	0	1	1244604	0.000001	0.000001
Sulfurimicrobium lacus	2715678	S	1	0	1	1244604	0.000001	0.000001
[Ochrobactrum] quorumnocens	271865	S	1	0	1	1244604	0.000001	0.000001
Rhizobium sp. ADMK78	1813451	S	1	0	1	1244604	0.000001	0.000001
Rhizobium sp. NIBRBAC000502774	2590777	S	1	0	1	1244604	0.000001	0.000001
Rhizobium sp. NXC24	2048897	S	1	0	1	1244604	0.000001	0.000001
Rhizobium flavum	1335061	S	1	0	1	1244604	0.000001	0.000001
Rhizobium acidisoli	1538158	S	1	0	1	1244604	0.000001	0.000001
Rhizobium oryzihabitans	2267833	S	1	0	1	1244604	0.000001	0.000001
Rhizobium favelukesii	348824	S	1	0	1	1244604	0.000001	0.000001
Neorhizobium sp. NCHU2750	1825976	S	1	0	1	1244604	0.000001	0.000001
Sinorhizobium sp. RAC02	1842534	S	1	0	1	1244604	0.000001	0.000001
Sinorhizobium sp. BG8	2613773	S	1	0	1	1244604	0.000001	0.000001
Georhizobium profundi	2341112	S	1	0	1	1244604	0.000001	0.000001
Bradyrhizobium sp. CCBAU 53338	1325111	S	1	0	1	1244604	0.000001	0.000001
Bradyrhizobium sp. CCBAU 051011	858422	S	1	0	1	1244604	0.000001	0.000001
Bradyrhizobium sp. WSM471	319017	S	1	0	1	1244604	0.000001	0.000001
Bradyrhizobium vignae	1549949	S	1	0	1	1244604	0.000001	0.000001
Bradyrhizobium amphicarpaeae	1404768	S	1	0	1	1244604	0.000001	0.000001
Bradyrhizobium arachidis	858423	S	1	0	1	1244604	0.000001	0.000001
Nitrobacter winogradskyi	913	S	1	0	1	1244604	0.000001	0.000001
Afipia sp. GAS231	1882747	S	1	0	1	1244604	0.000001	0.000001
Mesorhizobium sp. J8	2777475	S	1	0	1	1244604	0.000001	0.000001
Mesorhizobium sp. INR15	2654248	S	1	0	1	1244604	0.000001	0.000001
Mesorhizobium sp. M7A.F.Ce.TU.012.03.2.1	2493681	S	1	0	1	1244604	0.000001	0.000001
Mesorhizobium sp. M8A.F.Ca.ET.057.01.1.1	2493679	S	1	0	1	1244604	0.000001	0.000001
Mesorhizobium sp. M7D.F.Ca.US.005.01.1.1	2493678	S	1	0	1	1244604	0.000001	0.000001
Mesorhizobium sp. M1B.F.Ca.ET.045.04.1.1	2493673	S	1	0	1	1244604	0.000001	0.000001
Mesorhizobium sp. N3	675281	S	1	0	1	1244604	0.000001	0.000001
Mesorhizobium sp. DCY119	2108445	S	1	0	1	1244604	0.000001	0.000001
Mesorhizobium huakuii	28104	S	1	0	1	1244604	0.000001	0.000001
Oricola thermophila	2742145	S	1	0	1	1244604	0.000001	0.000001
Methylobacterium sp. 17Sr1-43	2202828	S	1	0	1	1244604	0.000001	0.000001
Methylobacterium aquaticum	270351	S	1	0	1	1244604	0.000001	0.000001
Microvirga sp. VF16	2807101	S	1	0	1	1244604	0.000001	0.000001
Methylorubrum extorquens	408	S	1	0	1	1244604	0.000001	0.000001
Bartonella elizabethae	807	S	1	0	1	1244604	0.000001	0.000001
Bartonella grahamii	33045	S	1	0	1	1244604	0.000001	0.000001
Bartonella vinsonii	33047	S	1	0	1	1244604	0.000001	0.000001
Bartonella henselae	38323	S	1	0	1	1244604	0.000001	0.000001
Bartonella bacilliformis	774	S	1	0	1	1244604	0.000001	0.000001
Devosia sp. D6-9	2664417	S	1	0	1	1244604	0.000001	0.000001
Hyphomicrobium denitrificans	53399	S	1	0	1	1244604	0.000001	0.000001
Hyphomicrobium sp. MC1	717785	S	1	0	1	1244604	0.000001	0.000001
Aquabacter sp. L1I39	2820278	S	1	0	1	1244604	0.000001	0.000001
Maritalea myrionectae	454601	S	1	0	1	1244604	0.000001	0.000001
Pelagibacterium halotolerans	531813	S	1	0	1	1244604	0.000001	0.000001
Methyloligella sp. GL2	2742204	S	1	0	1	1244604	0.000001	0.000001
Azorhizobium caulinodans	7	S	1	0	1	1244604	0.000001	0.000001
Ancylobacter sp. TS-1	1850374	S	1	0	1	1244604	0.000001	0.000001
Xanthobacter sp. YN2	2528964	S	1	0	1	1244604	0.000001	0.000001
Labrys sp. KNU-23	2789216	S	1	0	1	1244604	0.000001	0.000001
Stappia indica	538381	S	1	0	1	1244604	0.000001	0.000001
Pannonibacter phragmitetus	121719	S	1	0	1	1244604	0.000001	0.000001
Candidatus Hodgkinia cicadicola	573658	S	1	0	1	1244604	0.000001	0.000001
Hartmannibacter diazotrophicus	1482074	S	1	0	1	1244604	0.000001	0.000001
Chelatococcus daeguensis	444444	S	1	0	1	1244604	0.000001	0.000001
Chelatococcus sp. CO-6	1702325	S	1	0	1	1244604	0.000001	0.000001
Cohaesibacter sp. ES.047	1798205	S	1	0	1	1244604	0.000001	0.000001
Lichenihabitans psoromatis	2528642	S	1	0	1	1244604	0.000001	0.000001
Candidatus Phaeomarinobacter ectocarpi	1458461	S	1	0	1	1244604	0.000001	0.000001
Methylocystis bryophila	655015	S	1	0	1	1244604	0.000001	0.000001
Paracoccus liaowanqingii	2560053	S	1	0	1	1244604	0.000001	0.000001
Paracoccus jeotgali	2065379	S	1	0	1	1244604	0.000001	0.000001
Paracoccus kondratievae	135740	S	1	0	1	1244604	0.000001	0.000001
Paracoccus pantotrophus	82367	S	1	0	1	1244604	0.000001	0.000001
Paracoccus aminophilus	34003	S	1	0	1	1244604	0.000001	0.000001
Roseovarius mucosus	215743	S	1	0	1	1244604	0.000001	0.000001
Sulfitobacter sp. JL08	2070369	S	1	0	1	1244604	0.000001	0.000001
Phaeobacter piscinae	1580596	S	1	0	1	1244604	0.000001	0.000001
Ruegeria sp. TM1040	292414	S	1	0	1	1244604	0.000001	0.000001
Celeribacter marinus	1397108	S	1	0	1	1244604	0.000001	0.000001
Celeribacter manganoxidans	1411902	S	1	0	1	1244604	0.000001	0.000001
Celeribacter ethanolicus	1758178	S	1	0	1	1244604	0.000001	0.000001
Octadecabacter sp. SW4	2602067	S	1	0	1	1244604	0.000001	0.000001
Octadecabacter antarcticus	1217908	S	1	0	1	1244604	0.000001	0.000001
Thioclava nitratireducens	1915078	S	1	0	1	1244604	0.000001	0.000001
Roseobacter litoralis	42443	S	1	0	1	1244604	0.000001	0.000001
Roseobacter ponti	1891787	S	1	0	1	1244604	0.000001	0.000001
Rhodobacter blasticus	1075	S	1	0	1	1244604	0.000001	0.000001
Salipiger pacificus	311180	S	1	0	1	1244604	0.000001	0.000001
Yangia sp. CCB-MM3	1792508	S	1	0	1	1244604	0.000001	0.000001
Leisingera aquaemixtae	1396826	S	1	0	1	1244604	0.000001	0.000001
Leisingera sp. NJS201	2508306	S	1	0	1	1244604	0.000001	0.000001
Pontivivens sp. MT2928	2789856	S	1	0	1	1244604	0.000001	0.000001
Silicimonas algicola	1826607	S	1	0	1	1244604	0.000001	0.000001
Epibacterium mobile	379347	S	1	0	1	1244604	0.000001	0.000001
Roseibacterium elongatum	159346	S	1	0	1	1244604	0.000001	0.000001
Monaibacterium sp. ALG8	2715211	S	1	0	1	1244604	0.000001	0.000001
Jannaschia sp. CCS1	290400	S	1	0	1	1244604	0.000001	0.000001
Planktomarina temperata	1284658	S	1	0	1	1244604	0.000001	0.000001
Pseudopuniceibacterium antarcticum	2613965	S	1	0	1	1244604	0.000001	0.000001
Paraoceanicella profunda	2579971	S	1	0	1	1244604	0.000001	0.000001
Thalassococcus sp. S3	2017482	S	1	0	1	1244604	0.000001	0.000001
Ketogulonicigenium vulgare	92945	S	1	0	1	1244604	0.000001	0.000001
Sagittula sp. P11	2009329	S	1	0	1	1244604	0.000001	0.000001
Pelagibaca abyssi	1250539	S	1	0	1	1244604	0.000001	0.000001
Dinoroseobacter shibae	215813	S	1	0	1	1244604	0.000001	0.000001
Sphingomonas sp. IC081	304378	S	1	0	1	1244604	0.000001	0.000001
Sphingomonas sp. MM-1	745310	S	1	0	1	1244604	0.000001	0.000001
Sphingomonas sp. LMO-1	2681549	S	1	0	1	1244604	0.000001	0.000001
Sphingomonas sp. PAMC26645	2565555	S	1	0	1	1244604	0.000001	0.000001
Sphingomonas sp. HDW15B	2714943	S	1	0	1	1244604	0.000001	0.000001
Sphingomonas sp. C8-2	2492837	S	1	0	1	1244604	0.000001	0.000001
Sphingomonas insulae	424800	S	1	0	1	1244604	0.000001	0.000001
Sphingomonas alpina	653931	S	1	0	1	1244604	0.000001	0.000001
Sphingomonas panacisoli	1813879	S	1	0	1	1244604	0.000001	0.000001
Sphingomonas panacis	1560345	S	1	0	1	1244604	0.000001	0.000001
Sphingobium sp. PAMC28499	2565554	S	1	0	1	1244604	0.000001	0.000001
Sphingobium sp. CAP-1	2676077	S	1	0	1	1244604	0.000001	0.000001
Sphingobium sp. KCTC 72723	2733867	S	1	0	1	1244604	0.000001	0.000001
Sphingobium sp. Cam5-1	2789327	S	1	0	1	1244604	0.000001	0.000001
Sphingobium chlorophenolicum	46429	S	1	0	1	1244604	0.000001	0.000001
Sphingopyxis sp. 113P3	292913	S	1	0	1	1244604	0.000001	0.000001
Sphingopyxis sp. FD7	1914525	S	1	0	1	1244604	0.000001	0.000001
Sphingopyxis sp. OPL5	2486273	S	1	0	1	1244604	0.000001	0.000001
Sphingopyxis macrogoltabida	33050	S	1	0	1	1244604	0.000001	0.000001
Sphingopyxis terrae	33052	S	1	0	1	1244604	0.000001	0.000001
Sphingopyxis fribergensis	1515612	S	1	0	1	1244604	0.000001	0.000001
Sphingopyxis lindanitolerans	2054227	S	1	0	1	1244604	0.000001	0.000001
Novosphingobium sp. ABRDHK2	2571749	S	1	0	1	1244604	0.000001	0.000001
Novosphingobium resinovorum	158500	S	1	0	1	1244604	0.000001	0.000001
Zymomonas mobilis	542	S	1	0	1	1244604	0.000001	0.000001
Tardibacter chloracetimidivorans	1921510	S	1	0	1	1244604	0.000001	0.000001
Tsuneonella flava	2055955	S	1	0	1	1244604	0.000001	0.000001
Porphyrobacter sp. HT-58-2	2023229	S	1	0	1	1244604	0.000001	0.000001
Sphingosinicella sp. BN140058	1892855	S	1	0	1	1244604	0.000001	0.000001
Azospirillum humicireducens	1226968	S	1	0	1	1244604	0.000001	0.000001
Hypericibacter terrae	2602015	S	1	0	1	1244604	0.000001	0.000001
Rhodospirillum rubrum	1085	S	1	0	1	1244604	0.000001	0.000001
Candidatus Endolissoclinum faulkneri	1263979	S	1	0	1	1244604	0.000001	0.000001
Acetobacter persici	1076596	S	1	0	1	1244604	0.000001	0.000001
Acidiphilium multivorum	62140	S	1	0	1	1244604	0.000001	0.000001
Kozakia baliensis	153496	S	1	0	1	1244604	0.000001	0.000001
Bombella sp. KACC 21507	2697033	S	1	0	1	1244604	0.000001	0.000001
Lichenicola cladoniae	1484109	S	1	0	1	1244604	0.000001	0.000001
Stella humosa	94	S	1	0	1	1244604	0.000001	0.000001
Terasakiella sp. SH-1	2560057	S	1	0	1	1244604	0.000001	0.000001
Wolbachia endosymbiont of Ctenocephalides felis wCfeJ	2732594	S	1	0	1	1244604	0.000001	0.000001
Wolbachia endosymbiont of Dirofilaria (Dirofilaria) immitis	1812115	S	1	0	1	1244604	0.000001	0.000001
Wolbachia endosymbiont of Cimex lectularius	246273	S	1	0	1	1244604	0.000001	0.000001
Anaplasma ovis	142058	S	1	0	1	1244604	0.000001	0.000001
Candidatus Sneabacter namystus	2601646	S	1	0	1	1244604	0.000001	0.000001
Brevundimonas sp. LM2	1938605	S	1	0	1	1244604	0.000001	0.000001
Brevundimonas sp. LVF2	2774190	S	1	0	1	1244604	0.000001	0.000001
Brevundimonas sp. GRTSA-9	2800818	S	1	0	1	1244604	0.000001	0.000001
Caulobacter segnis	88688	S	1	0	1	1244604	0.000001	0.000001
Caulobacter rhizosphaerae	2010972	S	1	0	1	1244604	0.000001	0.000001
Phenylobacterium zucineum	284016	S	1	0	1	1244604	0.000001	0.000001
Terricaulis silvestris	2686094	S	1	0	1	1244604	0.000001	0.000001
Candidatus Pelagibacter sp. HIMB1321	1388755	S	1	0	1	1244604	0.000001	0.000001
Candidatus Pelagibacter sp. RS39	1977864	S	1	0	1	1244604	0.000001	0.000001
Candidatus Pelagibacter sp. FZCC0015	2268451	S	1	0	1	1244604	0.000001	0.000001
Phreatobacter sp. NMCR1094	2570229	S	1	0	1	1244604	0.000001	0.000001
Kordiimonas pumila	2161677	S	1	0	1	1244604	0.000001	0.000001
Arcobacter anaerophilus	877500	S	1	0	1	1244604	0.000001	0.000001
Malaciobacter molluscorum	1032072	S	1	0	1	1244604	0.000001	0.000001
Halarcobacter bivalviorum	663364	S	1	0	1	1244604	0.000001	0.000001
Poseidonibacter lekithochrous	1904463	S	1	0	1	1244604	0.000001	0.000001
Campylobacter sp. RM6137	1660073	S	1	0	1	1244604	0.000001	0.000001
Campylobacter gracilis	824	S	1	0	1	1244604	0.000001	0.000001
Sulfurospirillum multivorans	66821	S	1	0	1	1244604	0.000001	0.000001
Sulfurimonas sp. NW10	2509341	S	1	0	1	1244604	0.000001	0.000001
Candidatus Sulfurimonas baltica	2740404	S	1	0	1	1244604	0.000001	0.000001
Sulfuricurvum kujiense	148813	S	1	0	1	1244604	0.000001	0.000001
Helicobacter cholecystus	45498	S	1	0	1	1244604	0.000001	0.000001
Haliangium ochraceum	80816	S	1	0	1	1244604	0.000001	0.000001
Desulfosarcina alkanivorans	571177	S	1	0	1	1244604	0.000001	0.000001
Desulfonema limicola	45656	S	1	0	1	1244604	0.000001	0.000001
Desulfobacula toluolica	28223	S	1	0	1	1244604	0.000001	0.000001
Desulfatibacillum aliphaticivorans	218208	S	1	0	1	1244604	0.000001	0.000001
Desulfobulbus oralis	1986146	S	1	0	1	1244604	0.000001	0.000001
Desulfocapsa sulfexigens	65555	S	1	0	1	1244604	0.000001	0.000001
Desulfurivibrio alkaliphilus	427923	S	1	0	1	1244604	0.000001	0.000001
Desulfovibrio gigas	879	S	1	0	1	1244604	0.000001	0.000001
Desulfovibrio piger	901	S	1	0	1	1244604	0.000001	0.000001
Desulfovibrio alaskensis	58180	S	1	0	1	1244604	0.000001	0.000001
Desulfovibrio sp. 86	2666132	S	1	0	1	1244604	0.000001	0.000001
Pseudodesulfovibrio piezophilus	879567	S	1	0	1	1244604	0.000001	0.000001
Geobacter sp. M18	443143	S	1	0	1	1244604	0.000001	0.000001
Geobacter sp. Jerry-YX	2815309	S	1	0	1	1244604	0.000001	0.000001
Geobacter pickeringii	345632	S	1	0	1	1244604	0.000001	0.000001
Geobacter daltonii	1203471	S	1	0	1	1244604	0.000001	0.000001
Desulfuromonas sp. DDH964	1823759	S	1	0	1	1244604	0.000001	0.000001
Syntrophotalea carbinolica	19	S	1	0	1	1244604	0.000001	0.000001
Syntrophotalea acetylenivorans	1842532	S	1	0	1	1244604	0.000001	0.000001
Desulfomonile tiedjei	2358	S	1	0	1	1244604	0.000001	0.000001
Syntrophus aciditrophicus	316277	S	1	0	1	1244604	0.000001	0.000001
Hippea maritima	84405	S	1	0	1	1244604	0.000001	0.000001
Silvanigrella aquatica	1915309	S	1	0	1	1244604	0.000001	0.000001
Halobacteriovorax marinus	97084	S	1	0	1	1244604	0.000001	0.000001
Bacillus bombysepticus	658666	S	1	0	1	1244604	0.000001	0.000001
Bacillus wiedmannii	1890302	S	1	0	1	1244604	0.000001	0.000001
Bacillus albus	2026189	S	1	0	1	1244604	0.000001	0.000001
Bacillus sp. ABP14	1892404	S	1	0	1	1244604	0.000001	0.000001
Bacillus sp. FJAT-42376	2014076	S	1	0	1	1244604	0.000001	0.000001
Bacillus sp. NSP9.1	1071078	S	1	0	1	1244604	0.000001	0.000001
Bacillus sp. BD59S	2499213	S	1	0	1	1244604	0.000001	0.000001
Bacillus sp. N3536	2666127	S	1	0	1	1244604	0.000001	0.000001
Bacillus sp. X1(2014)	1565991	S	1	0	1	1244604	0.000001	0.000001
Bacillus halotolerans	260554	S	1	0	1	1244604	0.000001	0.000001
Bacillus atrophaeus	1452	S	1	0	1	1244604	0.000001	0.000001
Bacillus tequilensis	227866	S	1	0	1	1244604	0.000001	0.000001
Bacillus sporothermodurans	46224	S	1	0	1	1244604	0.000001	0.000001
Bacillus vietnamensis	218284	S	1	0	1	1244604	0.000001	0.000001
Bacillus altitudinis	293387	S	1	0	1	1244604	0.000001	0.000001
Bacillus freudenreichii	1783501	S	1	0	1	1244604	0.000001	0.000001
Bacillus smithii	1479	S	1	0	1	1244604	0.000001	0.000001
Bacillus haynesii	1925021	S	1	0	1	1244604	0.000001	0.000001
Bacillus gobiensis	1441095	S	1	0	1	1244604	0.000001	0.000001
Peribacillus simplex	1478	S	1	0	1	1244604	0.000001	0.000001
Virgibacillus sp. MSP4-1	2700081	S	1	0	1	1244604	0.000001	0.000001
Anoxybacillus caldiproteolyticus	247480	S	1	0	1	1244604	0.000001	0.000001
Alkalihalobacillus clausii	79880	S	1	0	1	1244604	0.000001	0.000001
Alkalihalobacillus halodurans	86665	S	1	0	1	1244604	0.000001	0.000001
Halobacillus litoralis	45668	S	1	0	1	1244604	0.000001	0.000001
Geobacillus genomosp. 3	1921421	S	1	0	1	1244604	0.000001	0.000001
Oceanobacillus iheyensis	182710	S	1	0	1	1244604	0.000001	0.000001
Oceanobacillus zhaokaii	2052660	S	1	0	1	1244604	0.000001	0.000001
Salicibibacter halophilus	2502791	S	1	0	1	1244604	0.000001	0.000001
Pontibacillus sp. HMF3514	2692425	S	1	0	1	1244604	0.000001	0.000001
Lentibacillus amyloliquefaciens	1472767	S	1	0	1	1244604	0.000001	0.000001
Cytobacillus kochii	859143	S	1	0	1	1244604	0.000001	0.000001
Anaerobacillus isosaccharinicus	1532552	S	1	0	1	1244604	0.000001	0.000001
Radiobacillus deserti	2594883	S	1	0	1	1244604	0.000001	0.000001
Fictibacillus arsenicus	255247	S	1	0	1	1244604	0.000001	0.000001
Terribacillus goriensis	386490	S	1	0	1	1244604	0.000001	0.000001
Planococcus sp. PAMC 21323	1526927	S	1	0	1	1244604	0.000001	0.000001
Planococcus sp. Y42	2213202	S	1	0	1	1244604	0.000001	0.000001
Planococcus maritimus	192421	S	1	0	1	1244604	0.000001	0.000001
Planococcus rifietoensis	200991	S	1	0	1	1244604	0.000001	0.000001
Planococcus plakortidis	1038856	S	1	0	1	1244604	0.000001	0.000001
Planococcus versutus	1302659	S	1	0	1	1244604	0.000001	0.000001
Paenisporosarcina sp. K2R23-3	2320858	S	1	0	1	1244604	0.000001	0.000001
Paenibacillus sp. TB2019	2810347	S	1	0	1	1244604	0.000001	0.000001
Paenibacillus sp. RUD330	2023772	S	1	0	1	1244604	0.000001	0.000001
Paenibacillus sp. URB8-2	2741301	S	1	0	1	1244604	0.000001	0.000001
Paenibacillus mucilaginosus	61624	S	1	0	1	1244604	0.000001	0.000001
Paenibacillus alvei	44250	S	1	0	1	1244604	0.000001	0.000001
Paenibacillus jilunlii	682956	S	1	0	1	1244604	0.000001	0.000001
Paenibacillus xylanilyticus	248903	S	1	0	1	1244604	0.000001	0.000001
Paenibacillus barcinonensis	198119	S	1	0	1	1244604	0.000001	0.000001
Paenibacillus odorifer	189426	S	1	0	1	1244604	0.000001	0.000001
Paenibacillus graminis	189425	S	1	0	1	1244604	0.000001	0.000001
Paenibacillus naphthalenovorans	162209	S	1	0	1	1244604	0.000001	0.000001
Brevibacillus sp. FJAT-54423	2796470	S	1	0	1	1244604	0.000001	0.000001
Cohnella abietis	2507935	S	1	0	1	1244604	0.000001	0.000001
Cohnella sp. LGH	1619153	S	1	0	1	1244604	0.000001	0.000001
Staphylococcus equorum	246432	S	1	0	1	1244604	0.000001	0.000001
Staphylococcus pasteuri	45972	S	1	0	1	1244604	0.000001	0.000001
Staphylococcus debuckii	2044912	S	1	0	1	1244604	0.000001	0.000001
Staphylococcus hyicus	1284	S	1	0	1	1244604	0.000001	0.000001
Staphylococcus schleiferi	1295	S	1	0	1	1244604	0.000001	0.000001
Mammaliicoccus lentus	42858	S	1	0	1	1244604	0.000001	0.000001
Mammaliicoccus vitulinus	71237	S	1	0	1	1244604	0.000001	0.000001
Mammaliicoccus fleurettii	150056	S	1	0	1	1244604	0.000001	0.000001
Effusibacillus sp. skT53	2743772	S	1	0	1	1244604	0.000001	0.000001
Novibacillus thermophilus	1471761	S	1	0	1	1244604	0.000001	0.000001
Enterococcus sp. CR-Ec1	2057791	S	1	0	1	1244604	0.000001	0.000001
Enterococcus casseliflavus	37734	S	1	0	1	1244604	0.000001	0.000001
Enterococcus durans	53345	S	1	0	1	1244604	0.000001	0.000001
Enterococcus rotai	118060	S	1	0	1	1244604	0.000001	0.000001
Vagococcus coleopterorum	2714946	S	1	0	1	1244604	0.000001	0.000001
Lactobacillus delbrueckii	1584	S	1	0	1	1244604	0.000001	0.000001
Lactobacillus apis	303541	S	1	0	1	1244604	0.000001	0.000001
Lactobacillus jensenii	109790	S	1	0	1	1244604	0.000001	0.000001
Lactobacillus crispatus	47770	S	1	0	1	1244604	0.000001	0.000001
Lactobacillus acidophilus	1579	S	1	0	1	1244604	0.000001	0.000001
Companilactobacillus ginsenosidimutans	1007676	S	1	0	1	1244604	0.000001	0.000001
Leuconostoc carnosum	1252	S	1	0	1	1244604	0.000001	0.000001
Weissella viridescens	1629	S	1	0	1	1244604	0.000001	0.000001
Weissella cibaria	137591	S	1	0	1	1244604	0.000001	0.000001
Latilactobacillus fuchuensis	164393	S	1	0	1	1244604	0.000001	0.000001
Lacticaseibacillus paracasei	1597	S	1	0	1	1244604	0.000001	0.000001
Oenococcus oeni	1247	S	1	0	1	1244604	0.000001	0.000001
Lentilactobacillus kefiri	33962	S	1	0	1	1244604	0.000001	0.000001
Loigolactobacillus coryniformis	1610	S	1	0	1	1244604	0.000001	0.000001
Liquorilactobacillus hordei	468911	S	1	0	1	1244604	0.000001	0.000001
Bombilactobacillus bombi	1303590	S	1	0	1	1244604	0.000001	0.000001
Limosilactobacillus fermentum	1613	S	1	0	1	1244604	0.000001	0.000001
Pediococcus damnosus	51663	S	1	0	1	1244604	0.000001	0.000001
Streptococcus suis	1307	S	1	0	1	1244604	0.000001	0.000001
Streptococcus chenjunshii	2173853	S	1	0	1	1244604	0.000001	0.000001
Streptococcus acidominimus	1326	S	1	0	1	1244604	0.000001	0.000001
Streptococcus pseudoporcinus	361101	S	1	0	1	1244604	0.000001	0.000001
Streptococcus mitis	28037	S	1	0	1	1244604	0.000001	0.000001
Lactococcus piscium	1364	S	1	0	1	1244604	0.000001	0.000001
Aerococcus sanguinicola	119206	S	1	0	1	1244604	0.000001	0.000001
Clostridium sp. JN-1	2483110	S	1	0	1	1244604	0.000001	0.000001
Clostridium kluyveri	1534	S	1	0	1	1244604	0.000001	0.000001
Clostridium formicaceticum	1497	S	1	0	1	1244604	0.000001	0.000001
Hathewaya histolytica	1498	S	1	0	1	1244604	0.000001	0.000001
Romboutsia ilealis	1115758	S	1	0	1	1244604	0.000001	0.000001
Peptoclostridium acidaminophilum	1731	S	1	0	1	1244604	0.000001	0.000001
Peptacetobacter hiranonis	89152	S	1	0	1	1244604	0.000001	0.000001
Anaerocolumna cellulosilytica	433286	S	1	0	1	1244604	0.000001	0.000001
Roseburia hominis	301301	S	1	0	1	1244604	0.000001	0.000001
Anaerostipes rhamnosivorans	1229621	S	1	0	1	1244604	0.000001	0.000001
Lachnoclostridium phocaeense	1871021	S	1	0	1	1244604	0.000001	0.000001
Butyrivibrio proteoclasticus	43305	S	1	0	1	1244604	0.000001	0.000001
Ruminococcus champanellensis	1161942	S	1	0	1	1244604	0.000001	0.000001
Acetivibrio clariflavus	288965	S	1	0	1	1244604	0.000001	0.000001
Flavonifractor plautii	292800	S	1	0	1	1244604	0.000001	0.000001
Ruthenibacterium lactatiformans	1550024	S	1	0	1	1244604	0.000001	0.000001
Dehalobacterium formicoaceticum	51515	S	1	0	1	1244604	0.000001	0.000001
Desulfallas gibsoniae	102134	S	1	0	1	1244604	0.000001	0.000001
Aminipila sp. JN-18	2507160	S	1	0	1	1244604	0.000001	0.000001
Aminipila butyrica	433296	S	1	0	1	1244604	0.000001	0.000001
Thermaerobacter sp. PB12/4term	2293838	S	1	0	1	1244604	0.000001	0.000001
Syntrophomonas wolfei	863	S	1	0	1	1244604	0.000001	0.000001
Eubacterium sp. NSJ-61	2764325	S	1	0	1	1244604	0.000001	0.000001
Heliobacterium modesticaldum	35701	S	1	0	1	1244604	0.000001	0.000001
Christensenella minuta	626937	S	1	0	1	1244604	0.000001	0.000001
Thermoanaerobacterium thermosaccharolyticum	1517	S	1	0	1	1244604	0.000001	0.000001
Thermoanaerobacterium xylanolyticum	29329	S	1	0	1	1244604	0.000001	0.000001
Caldicellulosiruptor sp. YA01	2806205	S	1	0	1	1244604	0.000001	0.000001
Ammonifex degensii	42838	S	1	0	1	1244604	0.000001	0.000001
Moorella thermoacetica	1525	S	1	0	1	1244604	0.000001	0.000001
Halothermothrix orenii	31909	S	1	0	1	1244604	0.000001	0.000001
Anoxybacter fermentans	1323375	S	1	0	1	1244604	0.000001	0.000001
Biomaibacter acetigenes	2316383	S	1	0	1	1244604	0.000001	0.000001
Pelosinus sp. UFO1	484770	S	1	0	1	1244604	0.000001	0.000001
Megamonas hypermegale	158847	S	1	0	1	1244604	0.000001	0.000001
Dialister pneumosintes	39950	S	1	0	1	1244604	0.000001	0.000001
Acidaminococcus fermentans	905	S	1	0	1	1244604	0.000001	0.000001
Erysipelothrix larvae	1514105	S	1	0	1	1244604	0.000001	0.000001
Intestinibaculum porci	2487118	S	1	0	1	1244604	0.000001	0.000001
Amedibacterium intestinale	2583452	S	1	0	1	1244604	0.000001	0.000001
Keratinibaculum paraultunense	1278232	S	1	0	1	1244604	0.000001	0.000001
Gottschalkia acidurici	1556	S	1	0	1	1244604	0.000001	0.000001
Limnochorda pilosa	1555112	S	1	0	1	1244604	0.000001	0.000001
Streptomyces sp. RTd22	1841249	S	1	0	1	1244604	0.000001	0.000001
Streptomyces sp. So13.3	2136173	S	1	0	1	1244604	0.000001	0.000001
Streptomyces sp. SM18	1736046	S	1	0	1	1244604	0.000001	0.000001
Streptomyces sp. SAT1	1849967	S	1	0	1	1244604	0.000001	0.000001
Streptomyces sp. SGAir0924	2109593	S	1	0	1	1244604	0.000001	0.000001
Streptomyces sp. Tu 2975	2676871	S	1	0	1	1244604	0.000001	0.000001
Streptomyces sp. PBH53	1577075	S	1	0	1	1244604	0.000001	0.000001
Streptomyces sp. CMB-StM0423	2059884	S	1	0	1	1244604	0.000001	0.000001
Streptomyces sp. Go-475	2072505	S	1	0	1	1244604	0.000001	0.000001
Streptomyces sp. ZYC-3	2797636	S	1	0	1	1244604	0.000001	0.000001
Streptomyces sp. Rer75	2750011	S	1	0	1	1244604	0.000001	0.000001
Streptomyces sp. M2	646637	S	1	0	1	1244604	0.000001	0.000001
Streptomyces sp. SN-593	659352	S	1	0	1	1244604	0.000001	0.000001
Streptomyces sp. NA02536	2742133	S	1	0	1	1244604	0.000001	0.000001
Streptomyces sp. Z423-1	2730915	S	1	0	1	1244604	0.000001	0.000001
Streptomyces sp. jing01	2726118	S	1	0	1	1244604	0.000001	0.000001
Streptomyces sp. AgN23	1188315	S	1	0	1	1244604	0.000001	0.000001
Streptomyces sp. RPA4-2	2721244	S	1	0	1	1244604	0.000001	0.000001
Streptomyces sp. SCSIO 3032	1264596	S	1	0	1	1244604	0.000001	0.000001
Streptomyces sp. YIM 121038	2136401	S	1	0	1	1244604	0.000001	0.000001
Streptomyces sp. MBT27	1488356	S	1	0	1	1244604	0.000001	0.000001
Streptomyces sp. F8	1436085	S	1	0	1	1244604	0.000001	0.000001
Streptomyces anulatus	1892	S	1	0	1	1244604	0.000001	0.000001
Streptomyces xiamenensis	408015	S	1	0	1	1244604	0.000001	0.000001
Streptomyces alboflavus	67267	S	1	0	1	1244604	0.000001	0.000001
Streptomyces lincolnensis	1915	S	1	0	1	1244604	0.000001	0.000001
Streptomyces griseorubiginosus	67304	S	1	0	1	1244604	0.000001	0.000001
Streptomyces cyaneogriseus	68192	S	1	0	1	1244604	0.000001	0.000001
Streptomyces hundungensis	1077946	S	1	0	1	1244604	0.000001	0.000001
Streptomyces xinghaiensis	1038928	S	1	0	1	1244604	0.000001	0.000001
Streptomyces globosus	68209	S	1	0	1	1244604	0.000001	0.000001
Streptomyces incarnatus	665007	S	1	0	1	1244604	0.000001	0.000001
Streptomyces peucetius	1950	S	1	0	1	1244604	0.000001	0.000001
Streptomyces ambofaciens	1889	S	1	0	1	1244604	0.000001	0.000001
Streptomyces bingchenggensis	379067	S	1	0	1	1244604	0.000001	0.000001
Streptomyces albireticuli	1940	S	1	0	1	1244604	0.000001	0.000001
Streptomyces violaceusniger	68280	S	1	0	1	1244604	0.000001	0.000001
Streptomyces asterosporus	285570	S	1	0	1	1244604	0.000001	0.000001
Streptomyces armeniacus	83291	S	1	0	1	1244604	0.000001	0.000001
Streptomyces parvulus	146923	S	1	0	1	1244604	0.000001	0.000001
Streptomyces niveus	193462	S	1	0	1	1244604	0.000001	0.000001
Streptomyces spongiicola	1690221	S	1	0	1	1244604	0.000001	0.000001
Streptomyces chromofuscus	42881	S	1	0	1	1244604	0.000001	0.000001
Streptomyces olivaceus	47716	S	1	0	1	1244604	0.000001	0.000001
Streptomyces collinus	42684	S	1	0	1	1244604	0.000001	0.000001
Streptomyces glaucescens	1907	S	1	0	1	1244604	0.000001	0.000001
Streptomyces capitiformicae	2014920	S	1	0	1	1244604	0.000001	0.000001
Streptomyces dengpaensis	2049881	S	1	0	1	1244604	0.000001	0.000001
Streptomyces qaidamensis	1783515	S	1	0	1	1244604	0.000001	0.000001
Streptomyces subrutilus	36818	S	1	0	1	1244604	0.000001	0.000001
Streptomyces hygroscopicus	1912	S	1	0	1	1244604	0.000001	0.000001
Streptomyces phaeolivaceus	2653200	S	1	0	1	1244604	0.000001	0.000001
Streptomyces aureoverticillatus	66871	S	1	0	1	1244604	0.000001	0.000001
Streptomyces qinzhouensis	2599401	S	1	0	1	1244604	0.000001	0.000001
Mycobacterium avium	1764	S	1	0	1	1244604	0.000001	0.000001
Mycobacterium parmense	185642	S	1	0	1	1244604	0.000001	0.000001
Mycobacterium florentinum	292462	S	1	0	1	1244604	0.000001	0.000001
Mycobacterium stomatepiae	470076	S	1	0	1	1244604	0.000001	0.000001
Mycobacterium shigaense	722731	S	1	0	1	1244604	0.000001	0.000001
Mycobacterium xenopi	1789	S	1	0	1	1244604	0.000001	0.000001
Mycobacterium heckeshornense	110505	S	1	0	1	1244604	0.000001	0.000001
Mycobacterium paraseoulense	590652	S	1	0	1	1244604	0.000001	0.000001
Mycobacterium dioxanotrophicus	482462	S	1	0	1	1244604	0.000001	0.000001
Mycolicibacterium mageritense	53462	S	1	0	1	1244604	0.000001	0.000001
Mycolicibacterium tokaiense	39695	S	1	0	1	1244604	0.000001	0.000001
Mycolicibacterium celeriflavum	1249101	S	1	0	1	1244604	0.000001	0.000001
Mycolicibacterium confluentis	28047	S	1	0	1	1244604	0.000001	0.000001
Mycolicibacterium gilvum	1804	S	1	0	1	1244604	0.000001	0.000001
Mycolicibacterium anyangense	1431246	S	1	0	1	1244604	0.000001	0.000001
Mycolicibacterium thermoresistibile	1797	S	1	0	1	1244604	0.000001	0.000001
Mycolicibacterium fallax	1793	S	1	0	1	1244604	0.000001	0.000001
Mycolicibacterium aurum	1791	S	1	0	1	1244604	0.000001	0.000001
Mycolicibacterium smegmatis	1772	S	1	0	1	1244604	0.000001	0.000001
Rhodococcus sp. WMMA185	679318	S	1	0	1	1244604	0.000001	0.000001
Rhodococcus sp. B7740	1564114	S	1	0	1	1244604	0.000001	0.000001
Rhodococcus sp. WB9	2594007	S	1	0	1	1244604	0.000001	0.000001
Rhodococcus sp. PBTS 1	1653478	S	1	0	1	1244604	0.000001	0.000001
Rhodococcus sp. MTM3W5.2	1805827	S	1	0	1	1244604	0.000001	0.000001
Rhodococcus fascians	1828	S	1	0	1	1244604	0.000001	0.000001
Rhodococcus rhodochrous	1829	S	1	0	1	1244604	0.000001	0.000001
Rhodococcus coprophilus	38310	S	1	0	1	1244604	0.000001	0.000001
Rhodococcus hoagii	43767	S	1	0	1	1244604	0.000001	0.000001
Rhodococcus triatomae	300028	S	1	0	1	1244604	0.000001	0.000001
Nocardia farcinica	37329	S	1	0	1	1244604	0.000001	0.000001
Nocardia seriolae	37332	S	1	0	1	1244604	0.000001	0.000001
Nocardia wallacei	480035	S	1	0	1	1244604	0.000001	0.000001
Nocardia yunnanensis	2382165	S	1	0	1	1244604	0.000001	0.000001
Corynebacterium sp. 1959	2675216	S	1	0	1	1244604	0.000001	0.000001
Corynebacterium sp. ZJ-599	2709394	S	1	0	1	1244604	0.000001	0.000001
Corynebacterium halotolerans	225326	S	1	0	1	1244604	0.000001	0.000001
Corynebacterium terpenotabidum	89154	S	1	0	1	1244604	0.000001	0.000001
Corynebacterium kroppenstedtii	161879	S	1	0	1	1244604	0.000001	0.000001
Corynebacterium argentoratense	42817	S	1	0	1	1244604	0.000001	0.000001
Corynebacterium vitaeruminis	38305	S	1	0	1	1244604	0.000001	0.000001
Corynebacterium tuberculostearicum	38304	S	1	0	1	1244604	0.000001	0.000001
Corynebacterium minutissimum	38301	S	1	0	1	1244604	0.000001	0.000001
Corynebacterium atypicum	191610	S	1	0	1	1244604	0.000001	0.000001
Corynebacterium xerosis	1725	S	1	0	1	1244604	0.000001	0.000001
Corynebacterium cystitidis	35757	S	1	0	1	1244604	0.000001	0.000001
Corynebacterium flavescens	28028	S	1	0	1	1244604	0.000001	0.000001
Gordonia bronchialis	2054	S	1	0	1	1244604	0.000001	0.000001
Microbacterium sp. XT11	367477	S	1	0	1	1244604	0.000001	0.000001
Microbacterium sp. JZ31	1906274	S	1	0	1	1244604	0.000001	0.000001
Microbacterium sp. Se63.02b	2709304	S	1	0	1	1244604	0.000001	0.000001
Microbacterium sp. Y-01	2048898	S	1	0	1	1244604	0.000001	0.000001
Microbacterium sp. 10M-3C3	2483401	S	1	0	1	1244604	0.000001	0.000001
Microbacterium testaceum	2033	S	1	0	1	1244604	0.000001	0.000001
Microbacterium chocolatum	84292	S	1	0	1	1244604	0.000001	0.000001
Microbacterium lemovicicum	1072463	S	1	0	1	1244604	0.000001	0.000001
Rathayibacter tritici	33888	S	1	0	1	1244604	0.000001	0.000001
Rathayibacter iranicus	59737	S	1	0	1	1244604	0.000001	0.000001
Agromyces sp. LHK192	2498704	S	1	0	1	1244604	0.000001	0.000001
Agromyces sp. HY052	2585717	S	1	0	1	1244604	0.000001	0.000001
Agromyces sp. KACC 19306	2592652	S	1	0	1	1244604	0.000001	0.000001
Agromyces sp. G127AT	2781962	S	1	0	1	1244604	0.000001	0.000001
Agrococcus jejuensis	399736	S	1	0	1	1244604	0.000001	0.000001
Frondihabitans sp. PAMC 28766	1795630	S	1	0	1	1244604	0.000001	0.000001
Cryobacterium soli	2220095	S	1	0	1	1244604	0.000001	0.000001
Cryobacterium sp. LW097	1978566	S	1	0	1	1244604	0.000001	0.000001
Salinibacterium hongtaonis	2079791	S	1	0	1	1244604	0.000001	0.000001
Salinibacterium sp. ZJ70	2708084	S	1	0	1	1244604	0.000001	0.000001
Herbiconiux sp. SALV-R1	2735133	S	1	0	1	1244604	0.000001	0.000001
Leucobacter triazinivorans	1784719	S	1	0	1	1244604	0.000001	0.000001
Clavibacter michiganensis	28447	S	1	0	1	1244604	0.000001	0.000001
Arthrobacter sp. PAMC25564	2565366	S	1	0	1	1244604	0.000001	0.000001
Arthrobacter sp. PGP41	2079227	S	1	0	1	1244604	0.000001	0.000001
Arthrobacter sp. U41	1849032	S	1	0	1	1244604	0.000001	0.000001
Arthrobacter sp. NEB 688	904039	S	1	0	1	1244604	0.000001	0.000001
Arthrobacter crystallopoietes	37928	S	1	0	1	1244604	0.000001	0.000001
Arthrobacter alpinus	656366	S	1	0	1	1244604	0.000001	0.000001
Kocuria turfanensis	388357	S	1	0	1	1244604	0.000001	0.000001
Kocuria sp. TGY1120_3	2711329	S	1	0	1	1244604	0.000001	0.000001
Pseudarthrobacter phenanthrenivorans	361575	S	1	0	1	1244604	0.000001	0.000001
Rothia dentocariosa	2047	S	1	0	1	1244604	0.000001	0.000001
Zhihengliuella sp. ISTPL4	2058657	S	1	0	1	1244604	0.000001	0.000001
Cellulomonas sp. Y8	2591145	S	1	0	1	1244604	0.000001	0.000001
Cellulomonas sp. JZ18	2654191	S	1	0	1	1244604	0.000001	0.000001
Ornithinimicrobium sp. H23M54	2594265	S	1	0	1	1244604	0.000001	0.000001
Serinicoccus marinus	247333	S	1	0	1	1244604	0.000001	0.000001
Janibacter melonis	262209	S	1	0	1	1244604	0.000001	0.000001
Janibacter sp. YB324	2761047	S	1	0	1	1244604	0.000001	0.000001
Phycicoccus endophyticus	1690220	S	1	0	1	1244604	0.000001	0.000001
Pedococcus dokdonensis	443156	S	1	0	1	1244604	0.000001	0.000001
Xylanimonas allomyrinae	2509459	S	1	0	1	1244604	0.000001	0.000001
Isoptericola dokdonensis	372663	S	1	0	1	1244604	0.000001	0.000001
Xylanimicrobium sp. FW10M-9	2509457	S	1	0	1	1244604	0.000001	0.000001
Georgenia sp. Z294	2585135	S	1	0	1	1244604	0.000001	0.000001
Ruania sp. HY168	2603206	S	1	0	1	1244604	0.000001	0.000001
Haloactinobacterium sp. RN3S43	2779775	S	1	0	1	1244604	0.000001	0.000001
Brachybacterium saurashtrense	556288	S	1	0	1	1244604	0.000001	0.000001
Sanguibacter keddieii	60920	S	1	0	1	1244604	0.000001	0.000001
Micromonospora sp. WMMA2032	2039870	S	1	0	1	1244604	0.000001	0.000001
Micromonospora sp. B006	2201999	S	1	0	1	1244604	0.000001	0.000001
Micromonospora sp. HM134	2583243	S	1	0	1	1244604	0.000001	0.000001
Micromonospora sp. 28ISP2-46	2749844	S	1	0	1	1244604	0.000001	0.000001
Micromonospora tulbaghiae	479978	S	1	0	1	1244604	0.000001	0.000001
Micromonospora zamorensis	709883	S	1	0	1	1244604	0.000001	0.000001
Micromonospora krabiensis	307121	S	1	0	1	1244604	0.000001	0.000001
Micromonospora siamensis	299152	S	1	0	1	1244604	0.000001	0.000001
Micromonospora maris	1003110	S	1	0	1	1244604	0.000001	0.000001
Micromonospora echinospora	1877	S	1	0	1	1244604	0.000001	0.000001
Micromonospora terminaliae	1914461	S	1	0	1	1244604	0.000001	0.000001
Micromonospora purpureochromogenes	47872	S	1	0	1	1244604	0.000001	0.000001
Micromonospora echinaurantiaca	47857	S	1	0	1	1244604	0.000001	0.000001
Micromonospora carbonacea	47853	S	1	0	1	1244604	0.000001	0.000001
Actinoplanes teichomyceticus	1867	S	1	0	1	1244604	0.000001	0.000001
Actinoplanes friuliensis	196914	S	1	0	1	1244604	0.000001	0.000001
Nocardioides sp. 603	2483798	S	1	0	1	1244604	0.000001	0.000001
Nocardioides sp. MC1495	2736757	S	1	0	1	1244604	0.000001	0.000001
Nocardioides sp. S-1144	2582905	S	1	0	1	1244604	0.000001	0.000001
Nocardioides sp. zg-579	2663857	S	1	0	1	1244604	0.000001	0.000001
Nocardioides marinisabuli	419476	S	1	0	1	1244604	0.000001	0.000001
Nocardioides mesophilus	433659	S	1	0	1	1244604	0.000001	0.000001
Nocardioides ungokensis	1643322	S	1	0	1	1244604	0.000001	0.000001
Nocardioides baekrokdamisoli	1804624	S	1	0	1	1244604	0.000001	0.000001
Nocardioides cynanchi	2558918	S	1	0	1	1244604	0.000001	0.000001
Nocardioides sambongensis	2589074	S	1	0	1	1244604	0.000001	0.000001
Aeromicrobium marinum	219314	S	1	0	1	1244604	0.000001	0.000001
Aeromicrobium choanae	1736691	S	1	0	1	1244604	0.000001	0.000001
Friedmanniella luteola	546871	S	1	0	1	1244604	0.000001	0.000001
Mumia sp. ZJ1417	2708082	S	1	0	1	1244604	0.000001	0.000001
Microlunatus sp. KUDC0627	2596828	S	1	0	1	1244604	0.000001	0.000001
Microlunatus sp. Gsoil 973	2672569	S	1	0	1	1244604	0.000001	0.000001
Tessaracoccus flavescens	399497	S	1	0	1	1244604	0.000001	0.000001
Propionibacterium freudenreichii	1744	S	1	0	1	1244604	0.000001	0.000001
Propionibacterium sp. oral taxon 193	671223	S	1	0	1	1244604	0.000001	0.000001
Acidipropionibacterium acidipropionici	1748	S	1	0	1	1244604	0.000001	0.000001
Acidipropionibacterium jensenii	1749	S	1	0	1	1244604	0.000001	0.000001
Pseudopropionibacterium propionicum	1750	S	1	0	1	1244604	0.000001	0.000001
Amycolatopsis orientalis	31958	S	1	0	1	1244604	0.000001	0.000001
Pseudonocardia sp. AL041005-10	445576	S	1	0	1	1244604	0.000001	0.000001
Pseudonocardia sp. CGMCC 4.1532	2761535	S	1	0	1	1244604	0.000001	0.000001
Saccharothrix espanaensis	103731	S	1	0	1	1244604	0.000001	0.000001
Saccharomonospora azurea	40988	S	1	0	1	1244604	0.000001	0.000001
Saccharomonospora marina	632569	S	1	0	1	1244604	0.000001	0.000001
Kibdelosporangium phytohabitans	860235	S	1	0	1	1244604	0.000001	0.000001
Prauserella marina	530584	S	1	0	1	1244604	0.000001	0.000001
Nonomuraea sp. ATCC 55076	1909395	S	1	0	1	1244604	0.000001	0.000001
Nonomuraea nitratireducens	2656914	S	1	0	1	1244604	0.000001	0.000001
Actinomyces wuliandei	2057743	S	1	0	1	1244604	0.000001	0.000001
Actinomyces qiguomingii	2057800	S	1	0	1	1244604	0.000001	0.000001
Actinomyces sp. oral taxon 171	706438	S	1	0	1	1244604	0.000001	0.000001
Arcanobacterium phocisimile	1302235	S	1	0	1	1244604	0.000001	0.000001
Flaviflexus sp. dk850	2758573	S	1	0	1	1244604	0.000001	0.000001
Actinotignum schaalii	59505	S	1	0	1	1244604	0.000001	0.000001
Schaalia odontolytica	1660	S	1	0	1	1244604	0.000001	0.000001
Bifidobacterium actinocoloniiforme	638619	S	1	0	1	1244604	0.000001	0.000001
Bifidobacterium dentium	1689	S	1	0	1	1244604	0.000001	0.000001
Gardnerella vaginalis	2702	S	1	0	1	1244604	0.000001	0.000001
Frankia sp. EAN1pec	298653	S	1	0	1	1244604	0.000001	0.000001
Frankia alni	1859	S	1	0	1	1244604	0.000001	0.000001
Candidatus Planktophila vernalis	1884907	S	1	0	1	1244604	0.000001	0.000001
Candidatus Planktophila dulcis	1884914	S	1	0	1	1244604	0.000001	0.000001
Modestobacter marinus	477641	S	1	0	1	1244604	0.000001	0.000001
Actinopolyspora erythraea	414996	S	1	0	1	1244604	0.000001	0.000001
Catenulispora acidiphila	304895	S	1	0	1	1244604	0.000001	0.000001
Epidermidibacterium keratini	1891644	S	1	0	1	1244604	0.000001	0.000001
Rubrobacter sp. SCSIO 52915	2653852	S	1	0	1	1244604	0.000001	0.000001
Baekduia soli	496014	S	1	0	1	1244604	0.000001	0.000001
Eggerthella sp. HF-1101	2690837	S	1	0	1	1244604	0.000001	0.000001
Cryptobacterium curtum	84163	S	1	0	1	1244604	0.000001	0.000001
Berryella intestinalis	1531429	S	1	0	1	1244604	0.000001	0.000001
Collinsella aerofaciens	74426	S	1	0	1	1244604	0.000001	0.000001
Olsenella sp. LZLJ-2	2779519	S	1	0	1	1244604	0.000001	0.000001
Egicoccus halophilus	1670830	S	1	0	1	1244604	0.000001	0.000001
Nostoc sp. C052	2576902	S	1	0	1	1244604	0.000001	0.000001
Nostoc punctiforme	272131	S	1	0	1	1244604	0.000001	0.000001
Nostoc flagelliforme	1306274	S	1	0	1	1244604	0.000001	0.000001
Anabaena sp. 90	46234	S	1	0	1	1244604	0.000001	0.000001
Calothrix sp. NIES-2098	1954171	S	1	0	1	1244604	0.000001	0.000001
Sphaerospermopsis kisseleviana	289435	S	1	0	1	1244604	0.000001	0.000001
Scytonema sp. NIES-4073	2005464	S	1	0	1	1244604	0.000001	0.000001
Synechococcus sp. CB0101	232348	S	1	0	1	1244604	0.000001	0.000001
Synechococcus sp. PCC 7003	374981	S	1	0	1	1244604	0.000001	0.000001
Synechococcus sp. Minos11	221341	S	1	0	1	1244604	0.000001	0.000001
Synechococcus sp. LTW-R	2751170	S	1	0	1	1244604	0.000001	0.000001
Acaryochloris marina	155978	S	1	0	1	1244604	0.000001	0.000001
Pseudanabaena sp. PCC 7367	82654	S	1	0	1	1244604	0.000001	0.000001
Crocosphaera subtropica	2546360	S	1	0	1	1244604	0.000001	0.000001
Geminocystis sp. NIES-3709	1617448	S	1	0	1	1244604	0.000001	0.000001
Cyanobacterium aponinum	379064	S	1	0	1	1244604	0.000001	0.000001
Oxynema sp. AP17	2064643	S	1	0	1	1244604	0.000001	0.000001
Stanieria sp. NIES-3757	1807358	S	1	0	1	1244604	0.000001	0.000001
Gloeobacter violaceus	33072	S	1	0	1	1244604	0.000001	0.000001
Chroococcidiopsis thermalis	54299	S	1	0	1	1244604	0.000001	0.000001
cyanobacterium endosymbiont of Rhopalodia gibberula	1763363	S	1	0	1	1244604	0.000001	0.000001
Spiroplasma poulsonii	2138	S	1	0	1	1244604	0.000001	0.000001
Spiroplasma clarkii	2139	S	1	0	1	1244604	0.000001	0.000001
Spiroplasma taiwanense	2145	S	1	0	1	1244604	0.000001	0.000001
Spiroplasma alleghenense	216931	S	1	0	1	1244604	0.000001	0.000001
Spiroplasma chinense	216932	S	1	0	1	1244604	0.000001	0.000001
Spiroplasma apis	2137	S	1	0	1	1244604	0.000001	0.000001
Spiroplasma citri	2133	S	1	0	1	1244604	0.000001	0.000001
Spiroplasma syrphidicola	216945	S	1	0	1	1244604	0.000001	0.000001
Mycoplasma sp. Mirounga ES2806-NAS	754516	S	1	0	1	1244604	0.000001	0.000001
Mycoplasma suis	57372	S	1	0	1	1244604	0.000001	0.000001
Mycoplasma phocicerebrale	142649	S	1	0	1	1244604	0.000001	0.000001
Mycoplasma phocidae	142651	S	1	0	1	1244604	0.000001	0.000001
Mycoplasma salivarium	2124	S	1	0	1	1244604	0.000001	0.000001
Mycoplasma neurolyticum	2120	S	1	0	1	1244604	0.000001	0.000001
Mycoplasma pulmonis	2107	S	1	0	1	1244604	0.000001	0.000001
Mycoplasma glycophilum	171285	S	1	0	1	1244604	0.000001	0.000001
Mycoplasma anatis	171279	S	1	0	1	1244604	0.000001	0.000001
Mycoplasma pullorum	48003	S	1	0	1	1244604	0.000001	0.000001
Mycoplasma bovigenitalium	2112	S	1	0	1	1244604	0.000001	0.000001
Deinococcus proteolyticus	55148	S	1	0	1	1244604	0.000001	0.000001
Deinococcus puniceus	1182568	S	1	0	1	1244604	0.000001	0.000001
Deinococcus metallilatus	1211322	S	1	0	1	1244604	0.000001	0.000001
Oceanithermus profundus	187137	S	1	0	1	1244604	0.000001	0.000001
Pelolinea submarina	913107	S	1	0	1	1244604	0.000001	0.000001
Ktedonosporobacter rubrisoli	2509675	S	1	0	1	1244604	0.000001	0.000001
Candidatus Promineofilum breve	1806508	S	1	0	1	1244604	0.000001	0.000001
Flavobacterium sp. P2-65	2748320	S	1	0	1	1244604	0.000001	0.000001
Flavobacterium sp. 140616W15	2478552	S	1	0	1	1244604	0.000001	0.000001
Flavobacterium haoranii	683124	S	1	0	1	1244604	0.000001	0.000001
Flavobacterium crassostreae	1763534	S	1	0	1	1244604	0.000001	0.000001
Flavobacterium arcticum	1784713	S	1	0	1	1244604	0.000001	0.000001
Flavobacterium pallidum	2172098	S	1	0	1	1244604	0.000001	0.000001
Flavobacterium sangjuense	2518177	S	1	0	1	1244604	0.000001	0.000001
Polaribacter sp. SA4-12	1312072	S	1	0	1	1244604	0.000001	0.000001
Polaribacter sp. SM13	2818493	S	1	0	1	1244604	0.000001	0.000001
Polaribacter sejongensis	985043	S	1	0	1	1244604	0.000001	0.000001
Polaribacter haliotis	1888915	S	1	0	1	1244604	0.000001	0.000001
Capnocytophaga sputigena	1019	S	1	0	1	1244604	0.000001	0.000001
Capnocytophaga canimorsus	28188	S	1	0	1	1244604	0.000001	0.000001
Formosa sp. Hel3_A1_48	1336795	S	1	0	1	1244604	0.000001	0.000001
Formosa agariphila	320324	S	1	0	1	1244604	0.000001	0.000001
Nonlabens sp. Hel1_33_55	1336802	S	1	0	1	1244604	0.000001	0.000001
Nonlabens dokdonensis	328515	S	1	0	1	1244604	0.000001	0.000001
Nonlabens ponticola	2496866	S	1	0	1	1244604	0.000001	0.000001
Algibacter alginicilyticus	1736674	S	1	0	1	1244604	0.000001	0.000001
Winogradskyella sp. PG-2	754409	S	1	0	1	1244604	0.000001	0.000001
Winogradskyella sp. PC-19	754417	S	1	0	1	1244604	0.000001	0.000001
Winogradskyella forsetii	2686077	S	1	0	1	1244604	0.000001	0.000001
Lacinutrix sp. 5H-3-7-4	983544	S	1	0	1	1244604	0.000001	0.000001
Muricauda lutaonensis	516051	S	1	0	1	1244604	0.000001	0.000001
Muricauda sp. 501str8	2698672	S	1	0	1	1244604	0.000001	0.000001
Psychroserpens sp. NJDZ02	2570561	S	1	0	1	1244604	0.000001	0.000001
Olleya aquimaris	639310	S	1	0	1	1244604	0.000001	0.000001
Galbibacter sp. BG1	1170699	S	1	0	1	1244604	0.000001	0.000001
Oceanihabitans sp. IOP_32	2529032	S	1	0	1	1244604	0.000001	0.000001
Zobellia galactanivorans	63186	S	1	0	1	1244604	0.000001	0.000001
Aequorivita sp. H23M31	2494375	S	1	0	1	1244604	0.000001	0.000001
Chryseobacterium sp. IHB B 17019	1721091	S	1	0	1	1244604	0.000001	0.000001
Chryseobacterium sp. JV274	1932669	S	1	0	1	1244604	0.000001	0.000001
Chryseobacterium sp. G0162	2487063	S	1	0	1	1244604	0.000001	0.000001
Chryseobacterium sp. NBC 122	2547600	S	1	0	1	1244604	0.000001	0.000001
Chryseobacterium arthrosphaerae	651561	S	1	0	1	1244604	0.000001	0.000001
Chryseobacterium piperi	558152	S	1	0	1	1244604	0.000001	0.000001
Chryseobacterium joostei	112234	S	1	0	1	1244604	0.000001	0.000001
Chryseobacterium balustinum	246	S	1	0	1	1244604	0.000001	0.000001
Epilithonimonas vandammei	2487072	S	1	0	1	1244604	0.000001	0.000001
Kaistella antarctica	266748	S	1	0	1	1244604	0.000001	0.000001
Empedobacter stercoris	1628248	S	1	0	1	1244604	0.000001	0.000001
Elizabethkingia sp. 2-6	2575699	S	1	0	1	1244604	0.000001	0.000001
Elizabethkingia sp. JS20170427COW	2583851	S	1	0	1	1244604	0.000001	0.000001
Weeksella virosa	1014	S	1	0	1	1244604	0.000001	0.000001
Cloacibacterium normanense	237258	S	1	0	1	1244604	0.000001	0.000001
Blattabacterium sp. DPU	2715232	S	1	0	1	1244604	0.000001	0.000001
Ichthyobacterium seriolicida	242600	S	1	0	1	1244604	0.000001	0.000001
Hymenobacter sp. DG25A	1385663	S	1	0	1	1244604	0.000001	0.000001
Hymenobacter sp. PAMC 26628	1484118	S	1	0	1	1244604	0.000001	0.000001
Hymenobacter sedentarius	1411621	S	1	0	1	1244604	0.000001	0.000001
Hymenobacter baengnokdamensis	2615203	S	1	0	1	1244604	0.000001	0.000001
Pontibacter russatus	2694929	S	1	0	1	1244604	0.000001	0.000001
Echinicola sp. 20G	2781961	S	1	0	1	1244604	0.000001	0.000001
Cyclobacterium marinum	104	S	1	0	1	1244604	0.000001	0.000001
Cyclobacterium amurskyense	320787	S	1	0	1	1244604	0.000001	0.000001
Aquiflexum balticum	280473	S	1	0	1	1244604	0.000001	0.000001
Spirosoma sp. PL0136	2710596	S	1	0	1	1244604	0.000001	0.000001
Spirosoma radiotolerans	1379870	S	1	0	1	1244604	0.000001	0.000001
Spirosoma endbachense	2666025	S	1	0	1	1244604	0.000001	0.000001
Flammeovirga sp. MY04	1191459	S	1	0	1	1244604	0.000001	0.000001
Chryseolinea soli	2321403	S	1	0	1	1244604	0.000001	0.000001
Sphingobacterium sp. ML3W	1538644	S	1	0	1	1244604	0.000001	0.000001
Sphingobacterium sp. dk4302	2662364	S	1	0	1	1244604	0.000001	0.000001
Sphingobacterium daejeonense	371142	S	1	0	1	1244604	0.000001	0.000001
Mucilaginibacter sp. 14171R-50	2703789	S	1	0	1	1244604	0.000001	0.000001
Mucilaginibacter ginsenosidivorans	398053	S	1	0	1	1244604	0.000001	0.000001
Mucilaginibacter ginsenosidivorax	862126	S	1	0	1	1244604	0.000001	0.000001
Mucilaginibacter celer	2305508	S	1	0	1	1244604	0.000001	0.000001
Pedobacter sp. G11	2482728	S	1	0	1	1244604	0.000001	0.000001
Pedobacter sp. KBS0701	2578106	S	1	0	1	1244604	0.000001	0.000001
Pedobacter roseus	336820	S	1	0	1	1244604	0.000001	0.000001
Pedobacter steynii	430522	S	1	0	1	1244604	0.000001	0.000001
Olivibacter sp. SDN3	2764720	S	1	0	1	1244604	0.000001	0.000001
Pseudopedobacter saltans	151895	S	1	0	1	1244604	0.000001	0.000001
Bacteroides thetaiotaomicron	818	S	1	0	1	1244604	0.000001	0.000001
Prevotella melaninogenica	28132	S	1	0	1	1244604	0.000001	0.000001
Alistipes onderdonkii	328813	S	1	0	1	1244604	0.000001	0.000001
Alistipes communis	2585118	S	1	0	1	1244604	0.000001	0.000001
Phocaeicola dorei	357276	S	1	0	1	1244604	0.000001	0.000001
Labilibaculum antarcticum	1717717	S	1	0	1	1244604	0.000001	0.000001
Chitinophaga pinensis	79329	S	1	0	1	1244604	0.000001	0.000001
Chitinophaga alhagiae	2203219	S	1	0	1	1244604	0.000001	0.000001
Arachidicoccus sp. B3-10	2545455	S	1	0	1	1244604	0.000001	0.000001
Lacibacter sp. S13-6-6	2760713	S	1	0	1	1244604	0.000001	0.000001
Pseudobacter ginsenosidimutans	661488	S	1	0	1	1244604	0.000001	0.000001
Saprospira grandis	1008	S	1	0	1	1244604	0.000001	0.000001
Chloroherpeton thalassium	100716	S	1	0	1	1244604	0.000001	0.000001
Chlorobaculum limnaeum	274537	S	1	0	1	1244604	0.000001	0.000001
Chlamydia trachomatis	813	S	1	0	1	1244604	0.000001	0.000001
Mariniblastus fucicola	980251	S	1	0	1	1244604	0.000001	0.000001
Rosistilla oblonga	2527990	S	1	0	1	1244604	0.000001	0.000001
Bythopirellula goksoyri	1400387	S	1	0	1	1244604	0.000001	0.000001
Aeoliella mucimassa	2527972	S	1	0	1	1244604	0.000001	0.000001
Gimesia algae	2527971	S	1	0	1	1244604	0.000001	0.000001
Gimesia panareensis	2527978	S	1	0	1	1244604	0.000001	0.000001
Alienimonas californiensis	2527989	S	1	0	1	1244604	0.000001	0.000001
Polystyrenella longa	2528007	S	1	0	1	1244604	0.000001	0.000001
Maioricimonas rarisocia	2528026	S	1	0	1	1244604	0.000001	0.000001
Caulifigura coniformis	2527983	S	1	0	1	1244604	0.000001	0.000001
Gemmata massiliana	1210884	S	1	0	1	1244604	0.000001	0.000001
Luteolibacter luteus	2728835	S	1	0	1	1244604	0.000001	0.000001
Roseimicrobium sp. ORNL1	2711231	S	1	0	1	1244604	0.000001	0.000001
Lacunisphaera limnophila	1838286	S	1	0	1	1244604	0.000001	0.000001
Methylacidimicrobium sp. B4	2796139	S	1	0	1	1244604	0.000001	0.000001
Treponema succinifaciens	167	S	1	0	1	1244604	0.000001	0.000001
Treponema brennaborense	81028	S	1	0	1	1244604	0.000001	0.000001
Spirochaeta africana	46355	S	1	0	1	1244604	0.000001	0.000001
Sphaerochaeta coccoides	273376	S	1	0	1	1244604	0.000001	0.000001
Salinispira pacifica	1307761	S	1	0	1	1244604	0.000001	0.000001
Oceanispirochaeta crateris	2518645	S	1	0	1	1244604	0.000001	0.000001
Borrelia anserina	143	S	1	0	1	1244604	0.000001	0.000001
Borreliella afzelii	29518	S	1	0	1	1244604	0.000001	0.000001
Borreliella valaisiana	62088	S	1	0	1	1244604	0.000001	0.000001
Borreliella bissettiae	64897	S	1	0	1	1244604	0.000001	0.000001
Fusobacterium gonidiaformans	849	S	1	0	1	1244604	0.000001	0.000001
Fusobacterium varium	856	S	1	0	1	1244604	0.000001	0.000001
Fusobacterium sp. NSJ-57	2764326	S	1	0	1	1244604	0.000001	0.000001
Leptotrichia trevisanii	109328	S	1	0	1	1244604	0.000001	0.000001
Leptotrichia wadei	157687	S	1	0	1	1244604	0.000001	0.000001
Streptobacillus moniliformis	34105	S	1	0	1	1244604	0.000001	0.000001
Sulfurihydrogenibium sp. YO3AOP1	436114	S	1	0	1	1244604	0.000001	0.000001
Terriglobus albidus	1592106	S	1	0	1	1244604	0.000001	0.000001
Granulicella tundricola	940615	S	1	0	1	1244604	0.000001	0.000001
Acidobacterium capsulatum	33075	S	1	0	1	1244604	0.000001	0.000001
Edaphobacter sp. 4G125	2763071	S	1	0	1	1244604	0.000001	0.000001
Acidisarcina polymorpha	2211140	S	1	0	1	1244604	0.000001	0.000001
Paludibaculum fermentans	1473598	S	1	0	1	1244604	0.000001	0.000001
Chloracidobacterium thermophilum	458033	S	1	0	1	1244604	0.000001	0.000001
Geovibrio thiophilus	139438	S	1	0	1	1244604	0.000001	0.000001
Nitrospira sp. KM1	1936990	S	1	0	1	1244604	0.000001	0.000001
Leptospirillum ferrooxidans	180	S	1	0	1	1244604	0.000001	0.000001
Thermodesulfobacterium sp. TA1	2234087	S	1	0	1	1244604	0.000001	0.000001
Candidatus Chazhemtobacterium aquaticus	2715735	S	1	0	1	1244604	0.000001	0.000001
Pseudothermotoga thermarum	119394	S	1	0	1	1244604	0.000001	0.000001
Endomicrobium proavitum	1408281	S	1	0	1	1244604	0.000001	0.000001
Abyssogena phaseoliformis symbiont	596095	S	1	0	1	1244604	0.000001	0.000001
Halorubrum sp. RHB-C	2739057	S	1	0	1	1244604	0.000001	0.000001
Halopenitus persicus	1048396	S	1	0	1	1244604	0.000001	0.000001
Halobonum sp. NJ-3-1	2743089	S	1	0	1	1244604	0.000001	0.000001
Halarchaeum sp. CBA1220	1853682	S	1	0	1	1244604	0.000001	0.000001
Salarchaeum sp. JOR-1	2599399	S	1	0	1	1244604	0.000001	0.000001
Natrialba magadii	13769	S	1	0	1	1244604	0.000001	0.000001
Halopiger xanaduensis	387343	S	1	0	1	1244604	0.000001	0.000001
Methanosarcina lacustris	170861	S	1	0	1	1244604	0.000001	0.000001
Methanosarcina horonobensis	418008	S	1	0	1	1244604	0.000001	0.000001
Methanohalophilus mahii	2176	S	1	0	1	1244604	0.000001	0.000001
Methanoculleus bourgensis	83986	S	1	0	1	1244604	0.000001	0.000001
Methanothermococcus okinawensis	155863	S	1	0	1	1244604	0.000001	0.000001
Methanobrevibacter ruminantium	83816	S	1	0	1	1244604	0.000001	0.000001
Methanobrevibacter millerae	230361	S	1	0	1	1244604	0.000001	0.000001
Methanobrevibacter sp. YE315	1609968	S	1	0	1	1244604	0.000001	0.000001
Methanosphaera stadtmanae	2317	S	1	0	1	1244604	0.000001	0.000001
Methanosphaera sp. BMS	1789762	S	1	0	1	1244604	0.000001	0.000001
Methanobacterium lacus	877455	S	1	0	1	1244604	0.000001	0.000001
Thermococcus sibiricus	172049	S	1	0	1	1244604	0.000001	0.000001
Archaeoglobus sulfaticallidus	1316941	S	1	0	1	1244604	0.000001	0.000001
Desulfurococcus amylolyticus	94694	S	1	0	1	1244604	0.000001	0.000001
Nitrosopumilus adriaticus	1580092	S	1	0	1	1244604	0.000001	0.000001
Candidatus Nitrosocosmicus franklandus	1798806	S	1	0	1	1244604	0.000001	0.000001
Nitrososphaera viennensis	1034015	S	1	0	1	1244604	0.000001	0.000001
Picrophilus torridus	82076	S	1	0	1	1244604	0.000001	0.000001
Candidatus Methanoplasma termitum	1577791	S	1	0	1	1244604	0.000001	0.000001
Aciduliprofundum boonei	379547	S	1	0	1	1244604	0.000001	0.000001
Candidatus Prometheoarchaeum syntrophicum	2594042	S	1	0	1	1244604	0.000001	0.000001
Serratia phage PS2	1481112	S	1	0	1	1244604	0.000001	0.000001
Aeromonas phage CC2	1204516	S	1	0	1	1244604	0.000001	0.000001
Morganella phage vB_MmoM_MP1	1852628	S	1	0	1	1244604	0.000001	0.000001
Aeromonas phage phiAS5	879630	S	1	0	1	1244604	0.000001	0.000001
Acinetobacter phage Ac42	762660	S	1	0	1	1244604	0.000001	0.000001
Vibrio virus KVP40	1914019	S	1	0	1	1244604	0.000001	0.000001
Aeromonas virus 65	260149	S	1	0	1	1244604	0.000001	0.000001
Aeromonas virus Aeh1	227470	S	1	0	1	1244604	0.000001	0.000001
Erwinia virus M7	1985307	S	1	0	1	1244604	0.000001	0.000001
Achromobacter phage Mano	2767570	S	1	0	1	1244604	0.000001	0.000001
Xanthomonas phage vB_XveM_DIBBI	1129194	S	1	0	1	1244604	0.000001	0.000001
Yersinia phage phiR1-37	331278	S	1	0	1	1244604	0.000001	0.000001
Erwinia virus EaH2	2169883	S	1	0	1	1244604	0.000001	0.000001
Aeromonas virus phiO18P	393598	S	1	0	1	1244604	0.000001	0.000001
Pseudomonas virus pf16	2560689	S	1	0	1	1244604	0.000001	0.000001
Vibrio virus VP4B	2560833	S	1	0	1	1244604	0.000001	0.000001
Escherichia virus Goslar	2734109	S	1	0	1	1244604	0.000001	0.000001
Acinetobacter virus AB1	1915208	S	1	0	1	1244604	0.000001	0.000001
Aeromonas virus 44RR2	115987	S	1	0	1	1244604	0.000001	0.000001
Serratia virus CHI14	2560752	S	1	0	1	1244604	0.000001	0.000001
Vibrio virus VP585	1922213	S	1	0	1	1244604	0.000001	0.000001
Enterobacter virus Eap1	2733615	S	1	0	1	1244604	0.000001	0.000001
Escherichia virus SRT7	2733617	S	1	0	1	1244604	0.000001	0.000001
Morganella virus MP2	2733649	S	1	0	1	1244604	0.000001	0.000001
Pectobacterium virus PP1	2733578	S	1	0	1	1244604	0.000001	0.000001
Pectobacterium virus PPWS2	2733337	S	1	0	1	1244604	0.000001	0.000001
Enterobacter phage Enc34	1150990	S	1	0	1	1244604	0.000001	0.000001
Serratia phage Eta	1282995	S	1	0	1	1244604	0.000001	0.000001
Paenibacillus phage PG1	754053	S	1	0	1	1244604	0.000001	0.000001
Enterobacter phage phiEap-2	1701257	S	1	0	1	1244604	0.000001	0.000001
Salmonella phage 35	1654888	S	1	0	1	1244604	0.000001	0.000001
Mycobacterium virus Pixie	1034114	S	1	0	1	1244604	0.000001	0.000001
Mycobacterium phage CRB2	2483623	S	1	0	1	1244604	0.000001	0.000001
Pseudomonas phage AF	1235689	S	1	0	1	1244604	0.000001	0.000001
Bacteroides phage crAss001	2301731	S	1	0	1	1244604	0.000001	0.000001
Klebsiella phage Pylas	2419682	S	1	0	1	1244604	0.000001	0.000001
Enterobacteria phage Sf101	1524881	S	1	0	1	1244604	0.000001	0.000001
Sulfitobacter phage EE36phi1	490913	S	1	0	1	1244604	0.000001	0.000001
Escherichia virus N4	10752	S	1	0	1	1244604	0.000001	0.000001
Escherichia virus EC3a	2734001	S	1	0	1	1244604	0.000001	0.000001
Salmonella virus STG2	2732034	S	1	0	1	1244604	0.000001	0.000001
Salmonella virus 118970sal2	1982565	S	1	0	1	1244604	0.000001	0.000001
Salmonella virus LVR16A	2732023	S	1	0	1	1244604	0.000001	0.000001
Escherichia virus VEc33	2608320	S	1	0	1	1244604	0.000001	0.000001
Salmonella phage L6jm	2713222	S	1	0	1	1244604	0.000001	0.000001
Escherichia virus AKFV33	1112008	S	1	0	1	1244604	0.000001	0.000001
Salmonella virus NR01	2733988	S	1	0	1	1244604	0.000001	0.000001
Escherichia virus phiLLS	2733987	S	1	0	1	1244604	0.000001	0.000001
Tanapox virus	99000	S	1	0	1	1244604	0.000001	0.000001
Skunkpox virus	160796	S	1	0	1	1244604	0.000001	0.000001
Youcai mosaic virus	228578	S	1	0	1	1244604	0.000001	0.000001
Mamestra configurata nucleopolyhedrovirus A	207830	S	1	0	1	1244604	0.000001	0.000001
Pandoravirus dulcis	1349409	S	1	0	1	1244604	0.000001	0.000001
